利福平	激素类避孕药	药效降低	据报道利福平可加快下列药物的代谢：抗惊厥药(如苯妥英)，抗心律失常药(如双异丙吡按、美西律、奎尼丁、妥卡尼)，口服抗凝血药，抗真菌药(如氟康唑、伊曲康唑、酮康唑等)，巴比土酸盐，β-阻滞剂，钙离子阻滞剂(如硫氮卓酮、硝苯吡啶、维拉帕米等)，氯霉素、克拉霉素、皮质类固醇、环孢霉素、洋地黄甙类、氯贝特、激素类避孕药，氨苯砜、安定、强力霉素、氟喹诺酮类(如环丙沙星)、氟哌啶醇、口服降糖药(磺酰脲)，左旋甲状腺素、美沙酮、麻醉性镇痛药，去甲替林、孕激素、奎林、茶碱、他克莫司、三环类抗抑郁药(阿米替林、去甲替林)和叠氮胸苷
贝那普利	噻嗪类利尿剂	药效提高，不良反应增加	由于噻嗪类利尿剂可以减少肾脏对锂的清除率，因此噻嗪类利尿剂与ACE抑制剂联合使用时（如贝那普利），发生锂中毒危险有可能会升高
维拉帕米	茚地那韦	药效提高	故应注意以下的相互作用：其他的细胞色素P450同功酶3A4抑制剂象吡咯类抗真菌剂（如克霉唑和酮康唑)，蛋白酶抑制剂(如利托那韦和茚地那韦)，大环内酯类制剂(如红霉素和克拉霉素)和西咪替丁：由于影响药物的代谢，会升高维拉帕米和/或以上药物在血浆中的浓度
齐多夫定	氟胞嘧啶	不良反应增加	与具有潜在肾毒性或骨髓抑制作用的药物，如全身用喷他咪、氨苯砜、乙胺嘧啶、复方磺胺甲恶唑、两性霉素、氟胞嘧啶、更昔洛韦、干扰素、长春新碱、长春花碱及阿霉素同时应用，特别在急性期治疗时亦可以使齐多夫定产生不良反应的机率增加
脂肪乳注射液	抗凝治疗	药效提高	使用脂肪乳注射液有可能导致出血时间延长与血小板的凝集出现抑制，因此同时接受抗凝治疗的患者，给予脂肪乳注射液时要特别小心，可以考虑减少抗凝剂的使用量
酚氨咖敏	阿托品	不良反应增加	奎尼丁与酚氨咖敏同用，其类似阿托品样的效应加剧
盐酸戊乙奎醚注射液	阿托品	药效提高	当盐酸戊乙奎醚注射液与其他抗胆碱药(阿托品、东莨菪碱和山莨菪碱等)伍用时有协同作用，应酌情减量
芦氟沙星	茶碱类	药效提高，不良反应增加	芦氟沙星与茶碱类合用时可能由于与细胞色素P450结合部位的竞争性抑制，导致茶碱类的肝消除明显减少，血消除半衰期(t1/2)延长，血药浓度升高，出现茶碱中毒症状，如恶心、呕吐、震颤、不安、激动、抽搐、心悸等，应避免合用，不能避免时应测定茶碱类血药浓度并调整剂量
维拉帕米	顺铂	药效降低	环磷酰胺、长春新碱、甲基苄肼、强的松、长春碱酰胺、阿霉素、顺铂等细胞毒性药物减少维拉帕米的吸收
米多君	肾上腺素	药效提高	α-肾上腺素能受体激动剂（如苯肾上腺素、右旋麻黄碱、麻黄素、苯丙醇胺）可能增强米多君的升压效应
咖啡因	异烟肼	药效提高	异烟肼和甲丙氨酯能促使咖啡因增效，提高后者脑组织内浓度55%，肝和肾内浓度则有所下降
阿托品	抗胆碱药	不良反应增加	与金刚烷胺、吩噻嗪类药、其他抗胆碱药、扑米酮、普鲁卡因胺、三环类抗抑郁药伍用，阿托品的毒副反应可加剧
异丙托溴铵	黄嘌呤衍生物	不良反应增加	同时使用黄嘌呤衍生物、及其他的β－肾上腺素能类和抗胆碱能类可増加异丙托溴铵副作用
舒巴坦	丙磺舒	药效提高	舒巴坦与丙磺舒联合应用，可降低舒巴坦的肾清除率使半衰期延长
阿司可咖	口服降糖药	药效提高	胰岛素或口服降糖药与阿司可咖同用时可加速降糖作用
碳酸钙D3片(II)	噻嗪类利尿药	药效提高，不良反应增加	碳酸钙D3片(II)与噻嗪类利尿药合用时，因增加肾小管对钙的重吸收而易发生高钙血症
辛伐他汀	克拉霉素	不良反应增加	当辛伐他汀与其它在治疗剂量下对细胞色素P4503A4有明显抑制作用的药物（如：环孢霉素、米贝地尔、伊曲康唑、酮康唑、红霉素、克拉霉素和奈法唑酮）或纤维酸类衍生物或盐酸合用时，导致横纹肌溶解的危险性增高
塞利洛尔	氢氯噻嗪	药效降低	食物能降低塞利洛尔的生物利用度，与氯噻酮及氢氯噻嗪合用时亦可能降低塞利洛尔的生物利用度
茶碱Ⅱ	克拉霉素	药效提高，不良反应增加	与克林霉素、林可霉素及某些大环内酯类（红霉素、罗红霉素、克拉霉素）、喹诺酮类抗菌药（伊诺沙星、环丙沙星）合用时，可降低茶碱Ⅱ在肝脏的清除率，使血药浓度升高，甚至出现毒性反应，应在给药前后调整茶碱Ⅱ的用量
托拉塞米	丙磺舒	药效降低	非甾体类抗炎药(如消炎痛)和丙磺舒可降低托拉塞米的利尿和降压作用
硝酸异山梨酯	伐地那非	药效提高	与磷酸二酯酶抑制剂(例如西地那非、他达那非、伐地那非)合用时，硝酸异山梨酯降低血压的作用将会增强(见第【禁忌】和【注意事项】)
咪康唑	西沙必利	药效降低，不良反应增加	咪康唑与西沙必利合用属禁忌，因合用时抑制细胞色素P-450代谢通道，可导致心律紊乱发生
联磺甲氧苄啶胶囊	利福平	药效降低	利福平与联磺甲氧苄啶胶囊合用时，可明显使联磺甲氧苄啶胶囊中的TMP清除增加和血清半衰期缩短
奎宁	筒箭毒碱	药效提高，不良反应增加	酸药及含铝制剂能延缓或减少奎宁的吸收；②抗凝药与奎宁合用后，抗凝作用可增强；③肌肉松弛药如琥珀胆碱、筒箭毒碱等与奎宁合同，可能会引起呼吸抑制；④奎尼丁与奎宁合用，金鸡纳反应可增加；⑤尿液碱化剂如碳酸氢钠等，可增加肾小管对奎宁的重吸收，导致奎宁血药浓度与毒性的增加；⑥与维生素K合用可增加奎宁的吸收；⑦与布克利嗪、赛克利嗪、美克利嗪、吩噻嗪类、噻吨类、曲美苄胺（trimethofenzamide）、氨基苷类抗生素合用可导致耳鸣、眩晕；⑧与硝苯地平（硝苯啶）合用，游离的奎宁浓度增加
阿莫西林克拉维酸	吲哚美辛	药效提高，不良反应增加	阿司匹林、吲哚美辛、保泰松、磺胺药可减少阿莫西林克拉维酸在肾小管的排泄，因而使阿莫西林克拉维酸的血药浓度升高，血消除半衰期（t1/2b）延长，毒性也可能增加
桂利嗪	苯妥英钠	药效降低	与苯妥英钠，卡马西平联合应用，氟桂利嗪的血药浓度降低
可乐定	β受体阻滞剂	不良反应增加	与β受体阻滞剂合用后停药，可增加可乐定的撤药综合症危象，故宜先停用β受体阻滞剂，再停用可乐定
非诺洛芬	甲氨蝶呤	不良反应增加	非诺洛芬可降低甲氨蝶呤的排泄，增高其血浓度，甚至可达中毒水平，故非诺洛芬不应与中或大剂量甲氨蝶呤同时应用
麻黄碱	缩宫素	药效提高，不良反应增加	麻黄碱与麦角新碱、麦角胺或缩宫素合用，可加剧血管收缩，导致严重高血压或外周组织缺血
阿托伐他汀	依法韦仑	药效降低	利福平和其它细胞色素P4503A4诱导剂：阿托伐他汀与细胞色素P4503A4诱导剂(如依法韦仑、利福平)联合应用能使阿托伐他汀血浆浓度产生不同水平的降低
复方对乙酰氨基酚	苯巴比妥	不良反应增加	复方对乙酰氨基酚不应与含有酒精的饮料、巴比妥类(如苯巴比妥)、解痉药类(如颠茄)同服，因可造成肝损害
双氯芬酸Ⅴ	甲氨蝶呤	药效提高，不良反应增加	双氯芬酸Ⅴ可降低甲氨蝶呤的排泄，增高其血浓度，甚至可达中毒水平，故双氯芬酸Ⅴ不应与中或大剂量甲氨喋呤同用
阿利吉仑	伊曲康唑	药效提高	由于P-gp抑制剂升高药物组织浓度的程度要大于血浆浓度，因此阿利吉仑与酮康唑或其他中效P-gp抑制剂（伊曲康唑、克拉霉素、泰利霉素、红霉素、胺碘酮）联合用药时需谨慎
西索米星氯化钠	头孢菌素类	药效降低，不良反应增加	西索米星氯化钠与β-内酰胺类(头孢菌素类或青霉素)混合可导致相互失活，需联合应用时必须分瓶注射
葡萄糖酸锌咀嚼片	四环素类	药效降低	葡萄糖酸锌咀嚼片可降低青霉胺及四环素类药品的作用
七氟烷	泮库溴铵	药效提高	当用作阿芬太尼—N2O麻醉的补充时，七氟烷和异氟烷同样可以强化泮库溴铵，维库溴铵和阿曲库铵的神经肌肉阻断作用
西索米星	两性霉素B	药效降低，不良反应增加	西索米星不宜与两性霉素B、头孢噻吩钠、呋喃妥因钠，磺胺嘧啶钠和四环素（以上均为注射液）联合应用，因可发生配伍禁忌
氨氯地平	硝酸酯	药效提高	⒀舌下硝酸甘油和长效硝酸酯制剂：与氨氯地平合用可加强抗心绞痛效应
戊巴比妥	奎尼丁	药效降低	戊巴比妥与奎尼丁合用时，可增加奎尼丁的代谢而减弱其作用
普萘洛尔	异烟肼	药效提高，不良反应增加	与CYP1A2酶底物或抑制剂合用，例如丙咪嗪、西咪替丁、环丙沙星、伏沙明、异烟肼、利托那韦、茶碱、齐留通、佐米曲普坦和利扎曲坦，可增加普萘洛尔的血浓度和/或毒性
柔红霉素	阿糖胞苷	不良反应增加	任何可能导致肝脏损害的药物如与柔红霉素同用，可增加阿霉素的肝毒性；与阿糖胞苷同用可导致坏死性结肠炎；与肝素、头孢菌素等混和应用易产生沉淀；
头孢哌酮	庆大霉素	药效降低，不良反应增加	头孢哌酮与下列药物注射剂有配伍禁忌：阿米卡星、庆大霉素、卡那霉素B、多西环素、甲氯芬酯、阿马林(缓脉灵)、苯海拉明、门冬酸钾镁、盐酸羟嗪(安太乐)、普鲁卡因胺、氨茶碱、丙氯拉嗪、细胞色素C、喷他佐辛(镇痛新)、抑肽酶等
水杨酸	抗酸药	药效降低	抗酸药如碳酸氢钠等可增加水杨酸自尿中的排泄，使血药浓度下降，不宜同用
颠茄片	吩噻嗪类	不良反应增加	颠茄片与金刚烷胺、美克洛嗪、吩噻嗪类药（氯丙嗪、奋乃静）、阿托品类药、普鲁卡因胺、三环类抗抑郁药等同用时，颠茄片的不良反应可加剧
非洛地平	苯妥英	药效降低	细胞色素P450诱导剂：通过诱导P450而增加非洛地平代谢的药物，如卡马西平、苯妥英、苯巴比妥、利福平和圣约翰草（hypericumperforatum），当非洛地平与卡马西平、苯妥英、苯巴比妥合用时，非洛地平的AUC降低93％，Cmax降低82％
利多卡因葡萄糖	氨苄西林	药效提高，不良反应增加	与西咪替丁以及b受体阻断剂如，普萘洛尔、美托洛尔、纳多洛尔合用，利多卡因经肝脏代谢受抑制，利多卡因血浓度增加，可发生心脏和神经系统不良反应，应调整利多卡因剂量，并应心电图监护及监测利多卡因血药浓度；（2）巴比妥类药物可促进利多卡因代谢，两药合用可引起心动过缓，窦性停搏；（3）与普鲁卡因胺合用，可产生一过性谵妄及幻觉，但不影响利多卡因葡萄糖血药浓度；（4）异丙基肾上腺素因增加肝血流量，可使利多卡因葡萄糖的总清除率升高；去甲肾上腺素因减少肝血流量，可使利多卡因葡萄糖总清除率下降；（5）与下列药品有配伍禁忌：苯巴比妥，硫喷妥钠，硝普钠，甘露醇，两性霉素B，氨苄西林，磺胺嘧啶
索他洛尔	丙吡胺	不良反应增加	抗心律失常药Ia类抗心律失常药如丙吡胺、奎尼丁和普鲁卡因胺以及其他Ⅲ类药物如胺碘酮，有可能延长不应期，不应与索他洛尔合用
丙戊酸钠	苯巴比妥	药效提高，不良反应增加	苯巴比妥：丙戊酸钠增加苯巴比妥的血药浓度（由于抑制了肝脏分解代谢），导致镇静作用，尤其是儿童
巴氨西林	口服避孕药	药效降低	巴氨西林可刺激雌激素代谢或减少其肠肝循环，因此可降低口服避孕药的效果
美托洛尔	氟西汀	药效提高	氟西汀：1例报道称氟西汀可抑制美托洛尔的代谢，使后者的作用增强
维拉帕米	利托那韦	药效提高	故应注意以下的相互作用：其他的细胞色素P450同功酶3A4抑制剂象吡咯类抗真菌剂（如克霉唑和酮康唑)，蛋白酶抑制剂(如利托那韦和茚地那韦)，大环内酯类制剂(如红霉素和克拉霉素)和西咪替丁：由于影响药物的代谢，会升高维拉帕米和/或以上药物在血浆中的浓度
氨溴索	红霉素	药效提高	氨溴索与红霉素、头孢氨苄、土霉素、阿莫西林、头孢呋新、多西环素等抗生素同时服用，可导致抗生素在支气管肺分泌物和咳痰中浓度升高
克拉霉素	地高辛	药效提高	同时使用地高辛和克拉霉素时，克拉霉素对Pgp的抑制会导致地高辛的暴露增加
阿托伐他汀	HMG-CoA还原酶抑制剂	不良反应增加	HMG-CoA还原酶抑制剂与吉非罗齐进行联合应用时，造成肌病/横纹肌溶解发生的风险增高，因此阿托伐他汀与吉非罗齐应避免联合应用（见【注意事项】）
美罗培南	丙磺舒	药效提高，不良反应增加	丙磺舒和美罗培南合用可竞争性激活肾小管分泌，抑制肾脏排泄，导致美罗培南清除半衰期延长，血药浓度增加，因此不推荐美罗培南和丙磺舒联用
丙硫氧嘧啶	抗凝药	药效提高	丙硫氧嘧啶与口服抗凝药合用可致后者疗效增加
利多卡因Ⅱ	硝普钠	不良反应增加	与西咪替丁以及β受体阻断剂如，普萘洛尔、美托洛尔、纳多洛尔合用，利多卡因经肝脏代谢受抑制，利多卡因血浓度增加，可发生心脏和神经系统不良反应，应调整利多卡因剂量，并应心电图监护及监测利多卡因血药浓度；(2)巴比妥类药物可促进利多卡因代谢，两药合用可引起心动过缓，窦性停搏；(3)与普鲁卡因胺合用，可产生一过性谵妄及幻觉，但不影响利多卡因Ⅱ血药浓度；(4)异丙基肾上腺素因增加肝血流量，可使利多卡因Ⅱ的总清除率升高；去甲肾上腺素因减少肝血流量，可使利多卡因Ⅱ总清除率下降；(5)与下列药品有配伍禁忌：苯巴比妥，硫喷妥钠，硝普钠，甘露醇，两性霉素B，氨苄西林，磺胺嘧啶
奥硝唑	维库溴铵	药效提高	奥硝唑可延缓肌肉松弛剂维库溴铵的作用
小儿双嘧啶	磺吡酮	药效提高，不良反应增加	与磺吡酮合用时可减少小儿双嘧啶中的磺胺嘧啶自肾小管的分泌，其血药浓度升高而持久，易产生毒性反应，因此在应用磺吡酮期间或应用其治疗后可能需要调整小儿双嘧啶的剂量
托拉塞米分散片	抗高血压药物	药效提高	托拉塞米分散片可加强抗高血压药物的作用
三硅酸镁	安定	药效降低	三硅酸镁与地西泮类药物（安定）合用时，后者吸收率降低
青霉素	阿司匹林	药效提高，不良反应增加	丙磺舒、阿司匹林、吲哚美辛、保泰松、磺胺药可减少青霉素在肾小管的排泄，使青霉素的血药浓度升高，血清半衰期延长，毒性也可能增加
棕榈氯霉素	麻醉药	药效提高	如在术前或术中应用，由于棕榈氯霉素对肝酶的抑制作用，可降低诱导麻醉药阿芬他尼的清除，延长其作用时间
奎宁	碳酸氢钠	不良反应增加	酸药及含铝制剂能延缓或减少奎宁的吸收；②抗凝药与奎宁合用后，抗凝作用可增强；③肌肉松弛药如琥珀胆碱、筒箭毒碱等与奎宁合同，可能会引起呼吸抑制；④奎尼丁与奎宁合用，金鸡纳反应可增加；⑤尿液碱化剂如碳酸氢钠等，可增加肾小管对奎宁的重吸收，导致奎宁血药浓度与毒性的增加；⑥与维生素K合用可增加奎宁的吸收；⑦与布克利嗪、赛克利嗪、美克利嗪、吩噻嗪类、噻吨类、曲美苄胺（trimethofenzamide）、氨基苷类抗生素合用可导致耳鸣、眩晕；⑧与硝苯地平（硝苯啶）合用，游离的奎宁浓度增加
氨酚帕马溴	氯霉素	药效提高，不良反应增加	氨酚帕马溴与氯霉素合用，可延长后者的半衰期，增强其毒性
脂肪乳注射液	神经阻滞剂	药效提高	据报告脂肪乳注射液与苯二氮卓类药物、副交感神经阻滞剂或吸入麻醉药合用时，可延长麻醉时间并降低呼吸频率
复方锌铁钙口服溶液	噻嗪类利尿剂	不良反应增加	复方锌铁钙口服溶液与噻嗪类利尿剂合用时易发生高钙血症
硫酸镁葡萄糖注射液	钙	药效降低	同时静注钙剂时，可减弱硫酸镁葡萄糖注射液对神经肌肉的作用
氟吡汀	酒精	药效提高	服用马来酸氟吡汀可加强酒精、一些镇静剂和肌肉松弛药物的作用
氯雷伪麻Ⅰ	氯霉素	药效提高，不良反应增加	与氯霉素合用，氯雷伪麻Ⅰ所含对乙酰氨基酚可延长氯霉素的半衰期，增强其毒性；
丙戊酸	奎宁	不良反应增加	与美尔奎宁合用：癫痫患者联合服用时，由于美尔奎宁可能导致丙戊酸代谢增加及自身的诱导发作的作用可使其存在癫痫发作的风险
美沙拉秦缓释片	抗凝药	不良反应增加	美沙拉秦缓释片与抗凝药物同时使用会增加出血倾向
异福酰胺	酮康唑	药效降低	与咪康唑或酮康唑合用可使后两者血药浓度减低，故异福酰胺不宜与咪唑类合用
加巴喷丁	可待因	药效降低	合用加巴喷丁（0.125g）使二氢可待因酮（10mg，N=50）的Cmax和AUC降低约3%~4%，合用加巴喷丁（0.5g）使二氢可待因酮（10mg，N=50）的Cmax和AUC降低约21%~22%
博来霉素	苯妥英	药效降低	与苯妥英合用，博来霉素可降低苯妥英在肠内的吸收而降低其作用
地巴唑	左旋多巴	药效降低	地巴唑与左旋多巴合用时，可降低后者的疗效
哌仑西平	西咪替丁	药效提高	西咪替丁、雷尼替丁、法莫替丁可增强哌仑西平疗效
布洛芬	肝素	药效提高，不良反应增加	布洛芬与肝素，双香豆素等抗凝药同用时，可导致凝血酶原时间延长，增加出血倾向
托吡酯	地高辛	药效降低	地高辛：一项单剂量临床研究发现因同时服用托吡酯，地高辛血清药-时曲线下面积下降12％
对乙酰氨基酚	巴比妥类	不良反应增加	应与巴比妥类（如苯巴比妥）或解痉药（如颠茄）的患者，长期应用对乙酰氨基酚可致肝损害
碳酸钙维D3元素片(4)	苯妥英钠	药效降低	碳酸钙维D3元素片(4)与苯妥英钠类及四环素类同用，二者吸收减低
地尔硫卓Ⅱ	三唑仑	药效提高	苯二氮桌：地尔硫卓Ⅱ可明显增加三唑仑和米达唑仑血浆峰浓度及延长其消除半衰期
维生素C钙	肝素	药效降低	维生素C钙与肝素或华法令联用，可引起凝血酶原时间缩短
萘普生	肝素	药效提高，不良反应增加	萘普生钠与肝素、双香豆素等抗凝剂合用，加强抗凝作用，可出现血倾向，并可能导致胃肠道溃疡
维拉帕米	顺铂	药效降低	细胞毒药物：环磷酰胺、长春新碱、甲基苄肼、强的松、长春碱酰胺、阿霉素、顺铂等可减少维拉帕米的吸收
氨氯地平	蛋白酶抑制剂	药效提高	与中度和强度CYP3A4抑制剂（蛋白酶抑制剂，唑类抗真菌剂，大环内酯类如红霉素或克拉霉素，维拉帕米或地尔硫卓）合用，可导致氨氯地平全身性暴露量增加，并可能需要减少剂量
艾司唑仑	酮康唑	药效提高，不良反应增加	艾司唑仑与抗真菌药酮康唑、伊曲康唑合用，可提高艾司唑仑疗效并增加其毒性
拉莫三嗪	阿扎那韦	药效降低	在一项健康成人志愿者参加的研究中，阿扎那韦/利托那韦（300mg/100mg）使拉莫三嗪（100mg，单次给药）的血浆AUC和Cmax分别平均下降32%和6%（参见“用法和用量—拉莫三嗪在特殊患者人群中的一般给药建议”）
洛伐他汀	阿奇霉素	不良反应增加	洛伐他汀与免疫抑制剂如环孢素、阿奇霉素、克拉霉素、红霉素、达那唑、伊曲康唑、吉非罗齐、烟酸等合用可增加肌溶解和急性肾功能衰竭发生的危险
胰岛素	锂	药效提高，不良反应增加	血管紧张素酶抑制剂、溴隐亭、氯贝特、酮康唑、锂、甲苯咪唑、吡多辛、茶碱等可通过不同方式直接或间接致血糖降低，胰岛素与上述药物合用时应适当减量
羧苄西林	盐酸四环素	药效降低，不良反应增加	羧苄西林与琥珀氯霉素、琥乙红霉素、盐酸土霉素、盐酸四环素、卡那霉素、链霉素、庆大霉素、妥布霉素、两性霉素B、维生素B族、维生素C、苯妥英钠、拟交感类药物、异丙嗪等有配伍禁忌
利福布汀	利托那韦	药效提高	逆转录病毒抑制剂如地拉夫定、印地那韦、奈非那韦、利托那韦等与利福布汀联合用药时均存在相互作用，这些药物会增加利福布汀的血药浓度，如合并用药，应注意调整利福布汀剂量
布地奈德	酮康唑	药效提高	细胞色素P4503A的强效抑制剂—酮康唑，可增加布地奈德的血药浓度，应注意临床检测
甲氧氯普胺	西咪替丁	药效降低	西咪替丁、慢溶型剂型地高辛同用，后者的胃肠道吸收减少，如间隔2小时服用可以减少这种影响；甲氧氯普胺还可增加地高辛的胆汁排出，从而改变其血浓度
阿莫西林克拉维酸	保泰松	药效提高，不良反应增加	司匹林、吲哚美辛、保泰松、磺胺药可减少阿莫西林克拉维酸在肾小管的排泄，因而使阿莫西林克拉维酸的血药浓度升高，血消除半衰期（t1/2）延长，毒性也可能增加
利福平滴眼液	氨苯砜	药效降低	肾上腺皮质激素(糖皮质激素﹑盐皮质激素)﹑抗凝药﹑氨茶碱﹑茶碱﹑氯霉素﹑氯贝丁酯﹑环胞素﹑维拉帕米(异搏定)﹑妥卡尼﹑普罗帕酮﹑甲氧苄啶﹑香豆素或茚满二酮衍生物﹑口服降血糖药﹑促皮质素﹑氨苯砜﹑洋地黄苷类﹑丙吡胺﹑奎尼丁等与利福平合用时，由于后者诱导肝微粒体酶活性，可使上述药物的药效减弱，因此除地高辛和氨苯砜外，在用利福平前和疗程中上述药物需调整剂量，利福平滴眼液与香豆素或茚满二酮类合用时应每日或定期测定凝血酶原时间，据以调整剂量
他扎罗汀	皮质激素类药物	不良反应增加	其他维A酸类药物或皮质激素类药物可能加重他扎罗汀的不良反应，应避免同时使用
戊酸雌二醇	氨苄西林	药效降低	联合服用活性炭和/或抗生素，例如氨苄西林或四环素后，可观察到肠道菌群改变导致药物浓度下降，可能导致戊酸雌二醇片的疗效减退
利福平	环磷酰胺	药效降低，不良反应增加	利福平可诱导肝微粒酶，增加抗肿瘤药达卡巴嗪，环磷酰胺的代谢，烷化代谢的形成，促使白细胞降低，因此需调整剂量
布洛芬混悬液	抗凝药	药效提高，不良反应增加	布洛芬混悬液与肝素、双香豆素等抗凝药同用时，可导致凝血酶原时间延长，增加出血倾向
辛伐他汀	奈法唑酮	不良反应增加	当辛伐他汀与其他在治疗剂量下对细胞色素P4503A4有明显抑制作用的药物(如：环孢霉素、米贝地尔、伊曲康唑、酮康唑、红霉素、克拉霉素和奈法唑酮)或纤维酸类衍生物或烟酸合用时，导致横纹肌溶解的危险性增高
奥沙西泮	利福平	药效降低	与利福平合用，增加奥沙西泮的消除，血药浓度降低
阿立哌唑	法莫替丁	药效降低	法莫替丁：同时服用阿立哌唑（单剂量15mg）和单剂量H2受体拮抗剂法莫替丁40mg（强抑酸制剂）可降低阿立哌唑的溶解性，并因此减少阿立哌唑的吸收，阿立哌唑和脱氢阿立哌唑的Cmax分别降低37%和21%，吸收（AUC）分别减少13%和15%
阿立哌唑	降压药	药效提高	因其拮抗α1—肾上腺素能受体，故阿立哌唑有增强某些降压药作用的可能性
维拉帕米	环磷酰胺	药效降低	环磷酰胺、长春新碱、甲基苄肼、强的松、长春碱酰胺、阿霉素、顺铂等细胞毒性药物减少维拉帕米的吸收
硝酸异山梨酯	麻黄碱	药效降低	拟交感神经类药（如肾上腺素、去甲肾上腺素或麻黄碱等）可降低硝酸异山梨酯的抗心绞痛效应
头孢氨苄	考来烯胺	药效降低	与考来烯胺（消胆胺）合用，可使头孢氨苄的平均血药浓度降低
西酞普兰	匹莫齐特	药效提高	使用西酞普兰40mg每天治疗的患者同时服用单剂量2mg的匹莫齐特可导致匹莫齐特AUC和最大血药浓度的升高，即使在整个研究中并不一致
非索非那定	抗酸剂	药效降低	钟内与铝、镁抗酸剂一起服用120mg盐酸非索非那定（2×60mg）会使盐酸非索非那定AUC降低41%、Cmax降低43%
吡嗪酰胺	磺吡酮	药效降低	吡嗪酰胺与别嘌呤醇、秋水仙碱、丙磺舒、磺吡酮合用，可增加血尿酸浓度而降低上述药物对痛风的疗效
西索米星	磺胺嘧啶	药效降低，不良反应增加	西索米星不宜与两性霉素B、头孢噻吩钠、呋喃妥因钠、磺胺嘧啶钠和四环素等（以上均为注射液）联合应用，因可发生配伍禁忌
氯化钠	林可霉素	药效提高，不良反应增加	与克林霉素、林可霉素及某些大环内酯类（红霉素、罗红霉素、克拉霉素）、喹诺酮类抗菌药（伊诺沙星、环丙沙星）合用时，可降低氯化钠在肝脏的清除率，使血药浓度升高，甚至出现毒性反应，应在给药前后调整氯化钠的用量
索磷布韦	奥卡西平	药效降低	中度P-gp诱导剂或中度CYP诱导剂类药品（例如奥卡西平、利福喷丁、莫达非尼或依非韦伦）可能会降低索磷布韦、维帕他韦和/或伏西瑞韦的血药浓度，从而导致索磷维伏片的疗效降低
苯唑西林	丙磺舒	药效提高	丙磺舒可减少苯唑西林的肾小管分泌，延长苯唑西林的血清半衰期
头孢氨苄	消胆胺	药效降低	与考来烯胺（消胆胺）合用时，可使头孢氨苄的平均血药浓度降低
地氟烷	阿片	药效提高	苯二氮卓类药物（咪哒唑仑25-50μg/kg）使地氟烷的MAC降低了16%，阿片类药物（芬太尼3-6μg/kg）使地氟烷的MAC降低了50%（请参考【用法用量】部分）
利多卡因	美托洛尔	药效提高，不良反应增加	与西咪替丁以及与受体阻滞剂如，普萘洛尔、美托洛尔、纳多洛尔合用，利多卡因经肝脏代谢受抑制，利多卡因血浓度增加，可发生心脏和神经系统不良反应
哌拉西林	丙磺舒	药效提高	哌拉西林与丙磺舒合用，可以使哌拉西林半衰期延长21％，他唑巴坦半衰期延长71%
异烟肼	安氟醚	药效提高，不良反应增加	与阿芬太尼（alfentanil）合用时，由于异烟肼为肝药酶抑制剂，可延长阿芬太尼的作用；与双硫仑(disulfiram)合用可增强其中枢神经系统作用，产生眩晕、动作不协调、易激惹、失眠等；与安氟醚合用可增加具有肾毒性的无机氟代谢物的形成
单硝酸异山梨酯缓释片	钙拮抗剂	药效提高，不良反应增加	同时服用扩张血管药，抗高血压药，β-阻断剂，钙拮抗剂，安定药，三环抗抑郁药或酒精，能增加单硝酸异山梨酯缓释片的高血压效应
替硝唑	西米替丁	药效提高	与西米替丁等抑制肝微粒体酶活性的药物合用时，可减慢替硝唑在肝内的代谢及排泄，延长替硝唑的血消除半衰期(t1/2β)，应根据血药浓度测定的结果调整剂量
布洛芬颗粒	双香豆素	药效提高，不良反应增加	布洛芬颗粒与肝素、双香豆素等抗凝药同用时，可导致凝血酶原时间延长，增加出血倾向
替格瑞洛	左炔诺孕酮	药效提高	替格瑞洛与左炔诺孕酮和炔雌醇合用时会使炔雌醇的暴露增加约20%，但不会改变左炔诺孕酮的PK
索磷布韦	依非韦伦	药效降低	中度P-gp诱导剂或中度CYP诱导剂类药品（如奥卡西平、莫达非尼或依非韦伦）可能会降低索磷布韦或维帕他韦的血浆浓度，从而导致Epclusa的疗效降低
雷贝拉唑	抗酸剂	药效降低	雷贝拉唑钠与抗酸剂同时服用以及在服用抗酸剂1小时后再服用时，雷贝拉唑的平均血浆中浓度曲线下面积分别下降8％和6％
复方对乙酰氨基酚	口服降糖药	药效提高，不良反应增加	复方对乙酰氨基酚可加强口服降糖药及甲氨蝶呤的作用，不应同用
门冬氨酸氨氯地平	β-受体阻滞剂	药效提高	β-受体阻滞剂：与门冬氨酸氨氯地平同用耐受良好，但可引起过度低血压，罕见病例可增加充血性心力衰竭发生的可能
青霉素V钾颗粒	雌激素	药效降低	青霉素V钾颗粒可刺激雌激素代谢或减少其肠肝循环，因此可降低口服避孕药的效果
利多卡因Ⅱ	甘露醇	药效提高，不良反应增加	与西咪替丁以及β受体阻断剂如，普萘洛尔、美托洛尔、纳多洛尔合用，利多卡因经肝脏代谢受抑制，利多卡因血浓度增加，可发生心脏和神经系统不良反应，应调整利多卡因剂量，并应心电图监护及监测利多卡因血药浓度；(2)巴比妥类药物可促进利多卡因代谢，两药合用可引起心动过缓，窦性停搏；(3)与普鲁卡因胺合用，可产生一过性谵妄及幻觉，但不影响利多卡因Ⅱ血药浓度；(4)异丙基肾上腺素因增加肝血流量，可使利多卡因Ⅱ的总清除率升高；去甲肾上腺素因减少肝血流量，可使利多卡因Ⅱ总清除率下降；(5)与下列药品有配伍禁忌：苯巴比妥，硫喷妥钠，硝普钠，甘露醇，两性霉素B，氨苄西林，磺胺嘧啶
氧	环孢素	药效提高	氧与环孢素合用，可使环孢素的血药浓度升高，必须监测环孢素血药浓度，并调整剂量
莫达非尼	伊曲康唑	药效提高	此外，由于莫达非尼的代谢消除部分与CYP3A4有关，与CYP3A4的强诱导剂（例如，卡马西平、苯巴比妥、利福平）或者强抑制剂（例如，酮康唑、伊曲康唑）合用会改变莫达非尼的血药浓度
卡马西平	口服避孕药	药效降低	与含雌激素的避孕药、环孢素、洋地黄类(可能地高辛除外)、雌激素、左旋甲状腺素或奎尼丁合用时，由于卡马西平对肝药酶的诱导，这些药的效应都会降低，用量应作调整，改用仅含孕激素(黄体酮)的口服避孕药
达比加群	贯叶连翘	药效提高	预计与P-gp诱导物（如：利福平、贯叶连翘（金丝桃）、卡马西平、或苯妥英等）联合使用会降低达比加群血药浓度，因此应该避免联合使用（参见【注意事项】和【药代动力学】）
瑞舒伐他汀钙片	炔雌醇	药效提高	口服避孕药/激素替代治疗（HRT）：同时使用瑞舒伐他汀钙片和口服避孕药，使炔雌醇和炔诺孕酮的AUC分别增加26％和34％
多巴胺	利尿药	药效提高	与利尿药同用，一方面由于多巴胺作用于多巴胺受体扩张肾血管，使肾血流量增加，可增加利尿作用；另一方面多巴胺自身还有直接的利尿作用
双氯芬酸钠肠溶胶囊	维拉帕米	药效提高	与维拉帕米、硝苯啶同用时，双氯芬酸钠肠溶胶囊的血药浓度增高
达诺瑞韦钠片	卡马西平	药效提高	CYP3A抑制剂（如酮康唑）或诱导剂（如利福平、利福布汀、苯巴比妥、苯妥英、卡马西平）会改变达诺瑞韦钠片的血药浓度
利福平	苯妥英	药效降低	据报道利福平可加快下列药物的代谢：抗惊厥药(如苯妥英)，抗心律失常药(如双异丙吡按、美西律、奎尼丁、妥卡尼)，口服抗凝血药，抗真菌药(如氟康唑、伊曲康唑、酮康唑等)，巴比土酸盐，β-阻滞剂，钙离子阻滞剂(如硫氮卓酮、硝苯吡啶、维拉帕米等)，氯霉素、克拉霉素、皮质类固醇、环孢霉素、洋地黄甙类、氯贝特、激素类避孕药，氨苯砜、安定、强力霉素、氟喹诺酮类(如环丙沙星)、氟哌啶醇、口服降糖药(磺酰脲)，左旋甲状腺素、美沙酮、麻醉性镇痛药，去甲替林、孕激素、奎林、茶碱、他克莫司、三环类抗抑郁药(阿米替林、去甲替林)和叠氮胸苷
己烯雌酚	卡马西平	药效降低	烯雌酚与卡马西平、苯巴比妥、苯妥英钠、扑米酮、利福平等同时使用，可减低己烯雌酚的效应
左旋多巴	酚噻嗪类	药效降低	多巴胺D2受体拮抗剂(如：酚噻嗪类，丁酰苯类和利培酮)和异烟肼可降低左旋多巴的疗效
利多卡因Ⅰ	普萘洛尔	药效提高，不良反应增加	与西咪替丁以及β受体阻断剂如，普萘洛尔、美托洛尔、纳多洛尔合用，利多卡因经肝脏代谢受抑制，利多卡因血浓度增加，可发生心脏和神经系统不良反应，应调整利多卡因剂量，并应心电图监护及监测利多卡因血药浓度；(2)巴比妥类药物可促进利多卡因代谢，两药合用可引起心动过缓，窦性停搏；(3)与普鲁卡因胺合用，可产生一过性谵妄及幻觉，但不影响利多卡因Ⅰ血药浓度；(4)异丙基肾上腺素因增加肝血流量，可使利多卡因Ⅰ的总清除率升高；去甲肾上腺素因减少肝血流量，可使利多卡因Ⅰ总清除率下降；(5)与下列药品有配伍禁忌：苯巴比妥，硫喷妥钠，硝普钠，甘露醇，两性霉素B，氨苄西林，磺胺嘧啶
非诺贝特	磺脲类	药效提高	非诺贝特与其它髙蛋白结合率的药物合用时，可使它们的游离型增加，药效增强，如甲苯磺丁脲及其它磺脲类降糖药、苯妥英、呋塞米等，在降血脂治疗期间服用上述药物，则应调整降糖药及其它药的剂量
艾曲泊帕乙醇胺片	氟伏沙明	药效降低	可以抑制或诱导单酶的药品未必会显著影响血浆艾曲泊帕乙醇胺片浓度；而抑制或诱导多酶的药品有可能增加（如氟伏沙明）或减少（如利福平）艾曲泊帕乙醇胺片的浓度
雷米普利	胰岛素	药效提高，不良反应增加	－口服抗糖药（如磺脲类、双胍类）、胰岛素：由于潜在地降低胰岛素抵抗，雷米普利可增强降糖药效果，具产生低血糖的风险（尤其在治疗初期，应仔细监测血糖水平）
托拉塞米	氨基糖甙类	不良反应增加	可加强氨基糖甙类抗生素（如卡那霉素、庆大霉素、妥布霉素）、抑制细胞增殖的铂衍生物和头孢菌素的耳毒性和肾脏毒性效应，特别是大剂量托拉塞米治疗时；
洛匹那韦/利托那韦口服溶液	苄替地尔	不良反应增加	阿普唑仑、安非他酮、胺碘酮、阿咪唑、苄替地尔、西沙必利、氯拉折帕、氯氮平、右丙氧芬、地西泮、二氢麦角胺、恩卡肢、舒乐安定、麦角胺、氟卡胺、氟西泮、咪达唑仑、哌替啶、匹莫齐特、吡罗昔康、普罗帕酮、奎尼丁、利福布丁、特非那定、三唑仑和左吡登禁止用于洛匹那韦/利托那韦口服溶液治疗的病人，因为它们可能与洛匹那韦/利托那韦口服溶液发生相互作用，产生严重并发症的危险
胺碘酮	普鲁卡因胺	药效提高	胺碘酮可增高血浆中奎尼丁、普鲁卡因胺、氟卡尼及苯妥英的浓度
酮咯酸氨丁三醇	卡马西平	药效降低	酮咯酸氨丁三醇和抗癫痫药物（苯妥英，卡马西平）联合用药时可能发生癫痫，但这种可能性极小
硫酸氨基葡萄糖胶囊	四环素类	药效提高	硫酸氨基葡萄糖胶囊可增加四环素类药物在胃肠道的吸收，减少口服青霉素或氯霉素的吸收
复方蒿甲醚	本芴醇	不良反应增加	因此，复方蒿甲醚预先给药似乎增强了与静脉注射奎宁相关的QTc-延长的内在性风险，因为本芴醇的清除半衰期较长以及潜在的QT间期叠加效应
洛芬待因	丙磺舒	药效提高，不良反应增加	丙磺舒可降低洛芬待因的排泄，增加血药浓度，从而增加毒性，故同用时宜减少洛芬待因剂量
西索米星	四环素	药效降低，不良反应增加	西索米星不宜与两性霉素B、头孢噻吩钠、呋喃妥因钠、磺胺嘧啶钠和四环素等(以上均为注射液)联合应用，因可发生配伍禁忌
利鲁唑	阿米替林	药效提高	CYP1A2的抑制剂(如咖啡因，双氮芬酸，地西泮，尼麦角林，氣米帕明，丙咪嗪，氟伏沙明，非那西汀，茶碱，阿米替林以及喹诺酮类)可潜在降低利鲁唑的清除率，而CYP1A2的诱导剂(如卷烟烟气，炭烤的食物，利福平以及奥美拉唑)可增加利鲁唑的清除率
阿米替林	氟西汀	药效提高，不良反应增加	阿米替林与氟西汀或氟伏沙明合用，可增加两者的血浆浓度，出现惊厥，不良反应增加
利血平	巴比妥类	药效提高	巴比妥类可加强利血平的中枢镇静作用
毛花苷丙	肝素	药效降低	⑿与肝素同用，由于毛花苷丙可能部分抵消肝素的抗凝作用，需调整肝素用量
克拉霉素	西沙必利	药效提高，不良反应增加	西沙必利与克拉霉素合用会使病人血液中西沙必利浓度升高，导致Q-T间期延长，心律失常如室性心动过速、室颤和充血性心力衰竭
甲砜霉素	利福平	药效降低	苯巴比妥、利福平等肝药酶诱导剂与甲砜霉素合用时，可增强其代谢，致使血药浓度降低
凝结芽孢杆菌活菌	氨苄青霉素	药效降低	凝结芽孢杆菌对氨苄青霉素、新霉素、头孢唑啉、头孢呋辛、头孢噻肟、氯霉素、呋喃唑酮（痢特灵）、复方新诺明和氟哌酸等敏感，故凝结芽孢杆菌活菌不能与此类药物同时服用
氯贝酸铝	普伐他汀	不良反应增加	氯贝酸铝有可能引起肌病或横纹肌溶解，因此应尽量避免与HMG-CoA还原酶抑制剂，如普伐他汀、辛伐他汀等合用，以减少两者严重肌肉毒性发生的危险
非洛地平	苯妥英	药效降低	与卡马西平、苯妥英和苯巴比妥合用时非洛地平的AUC减小93%、Cmax减小82%
氟康唑葡萄糖	华法林	药效提高	氟康唑葡萄糖与华法林等双香豆素类抗凝药合用时，可增强双香豆素类抗凝药的抗凝作用，致凝血酶原时间延长，故应监测凝血酶原时间并谨慎使用
地拉䓬	瑞格列奈	药效提高	在一项健康志愿者的研究中，地拉䓬（多剂给药，30mg/kg/天）与CYP2C8底物瑞格列奈（单剂给药，0.5mg)联合使用使瑞格列奈的AUC和Cmax分别增加了131%(90%CI:103%〜164%)和62%(90%CI:42%~84%)
二甲双胍格列本脲胶囊	拟交感神经药	不良反应增加	噻嗪类和其他利尿药、皮质醇类、酚噻嗪类、甲状腺制剂、性激素类、口服避孕药、苯妥英钠、烟酸、拟交感神经药、钙离子通道阻滞剂，异烟肼可产生难以控制的高血糖，当病人同服二甲双胍格列本脲胶囊和上述药物时，应注意观察病人血糖水平的变化
多巴丝肼	多巴胺受体激动剂	药效提高，不良反应增加	多巴丝肼可与其他抗帕金森病药物（如抗胆碱能药物、金刚烷胺、溴隐亭和多巴胺受体激动剂等）联合使用，尽管治疗作用和不良反应可能同时增加
单硝酸异山梨酯Ⅱ	双氢麦角胺	药效提高	单硝酸异山梨酯Ⅱ可加强双氢麦角胺的升血压效应
普萘洛尔	氟西汀	药效提高	口服避孕药、环丙沙星、舍曲林、氟西汀、哌唑嗪、胰岛素等药可增强普萘洛尔作用
依非韦伦	HMG-CoA还原酶抑制剂	药效降低	未感染的志愿者合用依非韦伦(600毫克,口服每天一次)与阿托伐他汀(10毫克，口服每天一次),与单独服用阿托伐他汀相比,阿托伐他汀的稳态AUC和Cmax分别降低43%和12%,2-羟基阿托伐他汀分别降低35%和13%,4-羟基阿托伐他汀分别降低4%和47%,总的有活性的HMG-CoA还原酶抑制剂分别降低34%和20%
利多卡因Ⅱ	硫喷妥钠	药效提高，不良反应增加	与西咪替丁以及b受体阻断剂如，普萘洛尔、美托洛尔、纳多洛尔合用，利多卡因经肝脏代谢受抑制，利多卡因血浓度增加，可发生心脏和神经系统不良反应，应调整利多卡因剂量，并应心电图监护及监测利多卡因血药浓度；（2）巴比妥类药物可促进利多卡因代谢，两药合用可引起心动过缓，窦性停搏；（3）与普鲁卡因胺合用，可产生一过性谵妄及幻觉，但不影响利多卡因Ⅱ血药浓度；（4）异丙基肾上腺素因增加肝血流量，可使利多卡因Ⅱ的总清除率升高；去甲肾上腺素因减少肝血流量，可使利多卡因Ⅱ总清除率下降；（5）与下列药品有配伍禁忌：苯巴比妥，硫喷妥钠，硝普钠，甘露醇，两性霉素B，氨苄西林，磺胺嘧啶
吉米沙星	丙磺舒	药效提高	丙磺舒：对多剂量给予丙磺舒（总剂量=4.5g）的健康受试者，单剂量给予320mg的吉米沙星，吉米沙星的平均肾清除率降低了约50%，导致吉米沙星的AUC（0-inf）平均增加了45%，半衰期均值延长了1.6h，吉米沙星Cmax均值增加了8%
复方炔诺酮片	抗凝血	药效降低	复方炔诺酮片可减弱抗高血压药、抗凝血药以及降血糖药的疗效
异维A酸	甲氨蝶呤	药效提高，不良反应增加	异维A酸与卡马西平(Carbamazepine)同时应用，可导致卡马西平的血药浓度下降，与华法林(Warfarin)同时使用，可增强华法林的治疗效果，和甲氨蝶呤(MTX)同时使用，可因MTX的血药浓度增加而增加对肝脏的损害
阿立哌唑	卡马西平	药效降低	当卡马西平加到阿立哌唑治疗中时，阿立哌唑的剂量应加倍
茶碱氯化钠	罗红霉素	药效提高，不良反应增加	与克林霉素、林可霉素及某些大环内酯类(红霉素、罗红霉素、克拉霉素)、喹诺酮类抗菌药(伊诺沙星、环丙沙星)合用时，可降低茶碱氯化钠在肝脏的清除率，使血药浓度升高，甚至出现毒性反应，应在给药时调整茶碱氯化钠的用量
洛匹那韦/利托那韦口服溶液	吡罗昔康	不良反应增加	阿普唑仑、安非他酮、胺碘酮、阿咪唑、苄替地尔、西沙必利、氯拉折帕、氯氮平、右丙氧芬、地西泮、二氢麦角胺、恩卡肢、舒乐安定、麦角胺、氟卡胺、氟西泮、咪达唑仑、哌替啶、匹莫齐特、吡罗昔康、普罗帕酮、奎尼丁、利福布丁、特非那定、三唑仑和左吡登禁止用于洛匹那韦/利托那韦口服溶液治疗的病人，因为它们可能与洛匹那韦/利托那韦口服溶液发生相互作用，产生严重并发症的危险
非诺贝特	甲苯磺丁脲	药效提高	非诺贝特与其它高蛋白结合率的药物合用时，可使它们的游离型增加，药效增强，如甲苯磺丁脲及其它磺脲类降糖药、苯妥英、呋塞米等，在降血脂治疗期间服用上述药物，则应调整降糖药及其它药的剂量
他克莫司	尼鲁地平	药效提高，不良反应增加	已知会抑制细胞色素P4503A4酶系统的药物：根据体外试验，下列药物可以视为他克莫司代谢的潜在性抑制剂：溴麦亭、可的松、氨苯砜、麦角胺、乙炔雌二醇、甲地孕酮、依他康唑、交沙霉素、利多卡因、甲妥因、咪康唑、尼卡地平、尼鲁地平、尼伐地平、炔诺酮、奎尼丁、他莫昔芬、三醋酸竹桃霉素、维拉帕米
头孢氨苄	考来烯胺	药效降低	头孢氨苄与考来烯胺(消胆胺)合用时，头孢氨苄的平均血药峰浓度可降低
二氢加兰他敏	红霉素	药效降低	与红霉素合用，可减低二氢加兰他敏的疗效
非洛地平	美托洛尔	药效提高	非洛地平与β-受体阻滞剂合用时耐受性良好，但有报道非洛地平与美托洛尔合用时可使美托洛尔的药时曲线下面积AUC和峰浓度Cmax分别增加31%和38%
替硝唑	苯妥英钠	药效降低	同时应用苯妥英钠、苯巴比妥等诱导肝微粒体酶的药物，可加强替硝唑代谢，使血药浓度下降，而苯妥英钠排泄缓慢
甲硝唑	抗凝血剂	药效提高	甲硝唑能增强华法令和其它口服香豆素抗凝血剂的抗凝血作用，导致凝血酶原时间延长
安非他酮	苯妥英	药效提高	如有些药物可以诱导安非他酮的代谢（如卡马西平、镇静安眠剂、苯妥英），有些药物可以抑制安非他酮的代谢（如西咪替丁）
阿立哌唑	卡马西平	药效降低	当停用联合治疗中的卡马西平时，阿立哌唑的剂量应降低
小儿贝诺酯维B1	抗凝剂	药效提高	小儿贝诺酯维B1与口服抗凝剂同服可延长凝血酶原时间
桂利嗪	卡马西平	药效降低	与苯妥英钠，卡马西平联合应用，氟桂利嗪的血药浓度降低
氟西汀	SSRIs	不良反应增加	圣•约翰草：同其它SSRIs一样，氟西汀和草药圣•约翰草（金丝桃素）可能发生药效学相互作用，这会导致不良反应增加
拉莫三嗪分散片	安非他酮	药效提高	受试者多剂量口服安非他酮对单剂量口服拉莫三嗪分散片片的药代动力学无明显影响，但拉莫三嗪分散片葡萄糖醛酸的AUC有轻微增加
布地奈德	酮康唑	药效提高，不良反应增加	布地奈德的代谢转化可被由CYP3A4代谢的物质（例如伊曲康唑、酮康唑、利托那韦、奈非那韦、环孢素、炔雌醇和醋竹桃霉素）所抑制
肌苷氯化钠注射液	乳清酸	药效降低，不良反应增加	肌苷氯化钠注射液禁与下列注射液配伍：乳清酸、氯霉素、双嘧达莫、盐酸山梗菜碱、硫酸阿托品、氢溴酸东莨菪碱、盐酸氯丙嗪、盐酸异丙嗪、马来酸麦角新碱、盐酸普鲁卡因、硫喷妥钠、苯妥英钠、氯氮卓、盐酸去甲肾上腺素、盐酸丁卡因、利血平、硝普钠、降压嗪、呋噻米、利尿酸钠、促皮质素、维生素B12、盐酸苯海拉明、马来酸氯苯那敏、细胞色素C、盐酸万古霉素、盐酸四环素、二盐酸奎宁、盐酸阿糖胞苷、硫酸长春新碱以及所有菌苗和疫苗
阿立哌唑	帕罗西汀	药效提高	CYP3A4抑制剂（如酮康唑）或CYP2D6抑制剂（如奎尼丁、氟西汀、帕罗西汀）可以抑制阿立哌唑消除，使血药浓度升高
洛匹那韦/利托那韦口服溶液	安非他酮	不良反应增加	阿普唑仑、安非他酮、胺碘酮、阿咪唑、苄替地尔、西沙必利、氯拉折帕、氯氮平、右丙氧芬、地西泮、二氢麦角胺、恩卡肢、舒乐安定、麦角胺、氟卡胺、氟西泮、咪达唑仑、哌替啶、匹莫齐特、吡罗昔康、普罗帕酮、奎尼丁、利福布丁、特非那定、三唑仑和左吡登禁止用于洛匹那韦/利托那韦口服溶液治疗的病人，因为它们可能与洛匹那韦/利托那韦口服溶液发生相互作用，产生严重并发症的危险
利多卡因Ⅰ	西咪替丁	药效提高，不良反应增加	与西咪替丁以及b受体阻断剂如，普萘洛尔、美托洛尔、纳多洛尔合用，利多卡因经肝脏代谢受抑制，利多卡因血浓度增加，可发生心脏和神经系统不良反应，应调整利多卡因剂量，并应心电图监护及监测利多卡因血药浓度；（2）巴比妥类药物可促进利多卡因代谢，两药合用可引起心动过缓，窦性停搏；（3）与普鲁卡因胺合用，可产生一过性谵妄及幻觉，但不影响利多卡因Ⅰ血药浓度；（4）异丙基肾上腺素因增加肝血流量，可使利多卡因Ⅰ的总清除率升高；去甲肾上腺素因减少肝血流量，可使利多卡因Ⅰ总清除率下降；（5）与下列药品有配伍禁忌：苯巴比妥，硫喷妥钠，硝普钠，甘露醇，两性霉素B，氨苄西林，磺胺嘧啶
维拉帕米	阿霉素	药效降低	细胞毒药物：环磷酰胺、长春新碱、甲基苄肼、强的松、长春碱酰胺、阿霉素、顺铂等可减少维拉帕米的吸收
氢溴酸加兰他敏片	地高辛	不良反应增加	有报道氢溴酸加兰他敏片与地高辛合用时出现房室传导阻滞
氟康唑葡萄糖	环孢素	药效提高，不良反应增加	高剂量氟康唑葡萄糖和环孢素合用时，可使环孢素的血药浓度升高，致毒性反应发生的危险性增加，因此必须在监测环孢素血药浓度并调整剂量的情况下方可谨慎使用
酮洛芬Ⅱ	甲氨蝶呤	药效提高，不良反应增加	酮洛芬Ⅱ可降低甲氨蝶呤（MTX）的排泄，增高其血浓度，甚至可达中毒水平，故酮洛芬Ⅱ不应与中或大剂量甲氨蝶呤同用
罗红霉素	双氢麦角胺	不良反应增加	罗红霉素和麦角胺或双氢麦角胺的联合使用可以导致循环障碍，尤其是手指和脚趾
利托那韦口服溶液	左吡登	不良反应增加	阿普唑仑、安非他酮、胺碘酮、阿咪唑、苄替地尔、西沙必利、氯拉折帕、氯氮平、右丙氧芬、地西泮、二氢麦角胺、恩卡肢、舒乐安定、麦角胺、氟卡胺、氟西泮、咪达唑仑、哌替啶、匹莫齐特、吡罗昔康、普罗帕酮、奎尼丁、利福布丁、特非那定、三唑仑和左吡登禁止用于利托那韦口服溶液治疗的病人，因为它们可能与利托那韦口服溶液发生相互作用，产生严重并发症的危险
氨溴索	抗生素	药效提高	氨溴索与抗生素（阿莫西林、头孢呋辛、红霉素、强力霉素）同时服用，可导致抗生素在肺组织浓度升高
阿莫西林克拉维酸	抗凝剂	药效提高	有报道某些患者使用阿莫西林克拉维酸可延长出血及凝血酶原时间，因此使用抗凝剂治疗的患者应慎用阿莫西林克拉维酸
氨溴索	抗生素	药效提高	氨溴索与抗生素协同治疗(阿莫西林、头孢呋辛、红霉素、强力霉素)可导致抗生素在肺组织浓度升高
唑尼沙胺	卡马西平	药效降低	对于唑尼沙胺每次用药剂量为400mg的患者，如果同时使用苯妥英、卡马西平或苯巴比妥等肝酶诱导性抗癫痫药物，则唑尼沙胺的半衰期在27-38小时之间；如果同时使用的是丙戊酸等非肝酶诱导性的抗癫痫药物，则唑尼沙胺的半衰期为46小时
阿司匹林	NSAIDs	不良反应增加	非甾体抗炎药（NSAIDs）：阿司匹林与其它非甾体抗炎药合用，可能增加出血或导致肾功能降低
维生素D3	扑米酮	药效降低	巴比妥、苯妥英钠、抗惊厥药、扑米酮等可降低维生素D3的效应，因此长期服用抗惊厥药时应补给维生素D3，以防止骨软化症
他达拉非	葡萄柚	药效提高	尽管未对特定的相互作用进行研究，其他CYP3A4抑制剂，如红霉素，伊曲康唑和葡萄柚果汁，也可能会增加他达拉非的暴露水平
胰岛素	茶碱	药效提高，不良反应增加	血管紧张素酶抑制剂、溴隐亭、氯贝特、酮康唑、锂、甲苯咪唑、吡多辛、茶碱等可通过不同方式直接或间接致血糖降低，胰岛素与上述药物合用时应适当减量
苯扎贝特胶囊	免疫抑制剂	药效提高，不良反应增加	苯扎贝特胶囊主要经肾排泄，在与免疫抑制剂，如环孢素合用时，可增加后者的血药浓度和肾毒性，有导致肾功能恶化的危险，应减量或停药
托莫西汀	氟西汀	药效降低	在EM中，当联合使用CYP2D6抑制剂，如帕罗西汀、氟西汀和奎尼丁时，有必要调节盐酸托莫西汀的剂量（见【注意事项】下物相互作用）
利多卡因	β受体阻滞剂	药效提高，不良反应增加	与西咪替丁以及与β受体阻滞剂如，普萘洛尔、美托洛尔、纳多洛尔合用，利多卡因经肝脏代谢受抑制，利多卡因血浓度增加，可发生心脏和神经系统不良反应．应调整利多卡因剂量，并应心电图监护及监测利多卡因血药浓度
肝素	阿霉素	药效降低，不良反应增加	下列药物与肝素有配伍禁忌：卡那霉素、阿米卡星、柔红霉素、乳糖酸红霉素、硫酸庆大霉素、氢化考的松琥珀酸钠、多粘菌素B、阿霉素、妥布霉素、万古霉素、头孢孟多、头孢氧哌唑、头孢噻吩钠、氯喹、氯丙嗪、异丙嗪、麻醉性镇痛药
单硝酸异山梨酯Ⅲ	西地那非	药效提高，不良反应增加	和西地那非合用会加强单硝酸异山梨酯Ⅲ的降压作用(见禁忌)，这将导致危及生命的心血管并发症，所以正在接受单硝酸异山梨酯Ⅲ治疗的病人不可使用西地那非
吲达帕胺	皮质激素	药效降低	皮质激素、替可克肽（全身性）：降低吲达帕胺的降压效果（由于皮质激素引起水钠潴留）
卡马西平	丙戊酰胺	药效提高	另外，有报告说，丙戊酸、丙戊酰胺和扑痫酮能升高活性代谢物10,11-环氧卡马西平的血药浓度，因此，卡马西平的剂量需相应调节
米非司酮	红霉素	药效降低	其代谢有可能被酮康唑、伊曲康唑、红霉素和葡萄柚汁抑制（增加血清米非司酮水平）》此外，利福平、地塞米松、S.John麦芽汁和某些抗惊厥药（苯妥英、苯巴比妥、卡马西平）可能诱导米非司酮代谢（降低米非司酮血清水平）根据体外抑制资料，联合给予米非司酮可以导致本身是CYP3A4底物的药物血清水平增加，由于米非司酮从体内消除减慢，这种相互作用可以从给药后体内时间延长观察到
普萘洛尔	利多卡因	药效提高	与安替比林、茶碱类和利多卡因合用可降低普萘洛尔清除率
双氯芬酸钠注射液	维拉帕米	药效提高	与维拉帕米、硝苯啶同用时，双氯芬酸钠注射液的血药浓度增高
曲美替尼	环孢菌素	药效提高	由于不能排除强效抑制肝脏P-gp导致曲美替尼水平升高的可能性，建议曲美替尼应谨慎合用强效P-gp抑制剂（如维拉帕米、环孢菌素、利托那韦、奎尼丁和伊曲康唑）
阿莫西林	四环素	药效降低	一些药品，比如氯霉素，红霉素或四环素与阿莫西林合用，可减弱弱阿莫西林杀菌作用
氯吡格雷	NSAIDs	不良反应增加	非甾体抗炎药（NSAIDs）：在健康志愿者进行的临床试验中，氯吡格雷与萘普生合用使胃肠道隐性出血增加
复方曲尼司特片	普萘洛尔	药效降低	同时应用β受体阻滞剂(如普萘洛尔)时，复方曲尼司特片的作用可被显著降低
氨酚帕马溴	巴比妥类	药效提高	氨酚帕马溴与中枢神经系统抑制剂（如安定）合用时有强化镇静作用和镇痛作用，应适当减量，与巴比妥类药物合用可延长麻醉时间
叶酸	甲氨蝶呤	药效降低	因此高剂量的亚叶酸可能降低甲氨蝶呤鞘内给药的效果
阿昔洛韦	丙磺舒	药效提高	与丙磺舒竞争性抑制有机酸分泌，合并用丙磺舒可使阿昔洛韦的尿路排泄减慢、半衰期延长，体内药物量蓄积
培哚普利	雌莫司汀	不良反应增加	雌莫司汀：联合使用培哚普利和雌莫司汀可增加不良反应的风险，例如血管性水肿的风险
异烟肼	酮康唑	药效降低	与咪康唑或酮康唑合用可使后两者血药浓度减低，故异烟肼不宜与咪唑类合用
利托那韦	二氢麦角胺	不良反应增加	阿普唑仑、安非他酮、胺碘酮、阿咪唑、苄替地尔、西沙必利、氯拉折帕、氯氮平、右丙氧芬、地西泮、二氢麦角胺、恩卡肢、舒乐安定、麦角胺、氟卡胺、氟西泮、咪达唑仑、哌替啶、匹莫齐特、吡罗昔康、普罗帕酮、奎尼丁、利福布丁、特非那定、三唑仑和左吡登禁止用于利托那韦治疗的病人，因为它们可能与利托那韦发生相互作用，产生严重并发症的危险
普拉克索	奎宁	药效提高	因此，活性成分肾脏清除途径的抑制剂，或通过这种途径清除的药物，如西咪替丁，金刚烷胺，以及美西律，齐多夫定，顺铂，奎宁和普鲁卡因胺可能会与普拉克索有相互作用，导致普拉克索清除率减少
磺啶冰黄片	骨髓抑制剂	不良反应增加	骨髓抑制剂与磺啶冰黄片同用时发生白细胞、血小板减少的机会增多
克拉霉素	丙吡胺	不良反应增加	有上市后报道，当克拉霉素和奎尼丁或丙吡胺合用时有扭转峰值现象发生
头孢米诺	利尿剂	药效降低，不良反应增加	本口与氨茶碱、磷酸吡哆醛配伍会降低效价或着色，故不得配伍；与呋喃硫胺、硫辛酸，氢化可的松琥珀酸钠及腺苷钴胺配伍后时间稍长会变色，故配伍后应尽快使用；与利尿剂呋(呋喃苯胺酸等)等合用有可能增加肾毒性，应谨慎使用，动物实验证实，头孢米诺影响酒精代谢，使血中乙醛浓度上升，显示双硫仑样作用，故用药期间或用药后应禁酒
普萘洛尔	尼卡地平	药效提高	与尼卡地平合用，普萘洛尔的Cmax和AUC均值分别增加了50%和30%，与尼索地平合用，增加了80%和47%
他唑巴坦	哌拉西林	药效提高	他唑巴坦与丙磺舒合用，可以使哌拉西林半衰期延长21％，他唑巴坦半衰期延长71%
吲哚美辛栓	吲达帕胺	药效降低	吲哚美辛栓还有阻止呋塞米、布美他尼及吲达帕胺等对血浆肾素活性(plasmareninactivity，PRA)增强的作用，对高血压病人评议其PRA的意义时应注意此点
利多卡因	两性霉素B	药效提高，不良反应增加	与西咪替丁以及b受体阻断剂如，普萘洛尔、美托洛尔、纳多洛尔合用，利多卡因经肝脏代谢受抑制，利多卡因血浓度增加，可发生心脏和神经系统不良反应，应调整利多卡因剂量，并应心电图监护及监测利多卡因血药浓度；（2）巴比妥类药物可促进利多卡因代谢，两药合用可引起心动过缓，窦性停搏；（3）与普鲁卡因胺合用，可产生一过性谵妄及幻觉，但不影响利多卡因血药浓度；（4）异丙基肾上腺素因增加肝血流量，可使利多卡因的总清除率升高；去甲肾上腺素因减少肝血流量，可使利多卡因总清除率下降；（5）与下列药品有配伍禁忌：苯巴比妥，硫喷妥钠，硝普钠，甘露醇，两性霉素B，氨苄西林，磺胺嘧啶
右旋酮洛芬氨丁三醇	丙磺舒	药效提高	右旋酮洛芬氨丁三醇不应与丙磺舒同用，因后者可明显降低右旋酮洛芬氨丁三醇肾脏清除率（降低66%）和蛋白结合率（降低28%），导致血药浓度增高
利福平	他克莫司	药效降低	据报道利福平可加快下列药物的代谢：抗惊厥药(如苯妥英)，抗心律失常药(如双异丙吡按、美西律、奎尼丁、妥卡尼)，口服抗凝血药，抗真菌药(如氟康唑、伊曲康唑、酮康唑等)，巴比土酸盐，β-阻滞剂，钙离子阻滞剂(如硫氮卓酮、硝苯吡啶、维拉帕米等)，氯霉素、克拉霉素、皮质类固醇、环孢霉素、洋地黄甙类、氯贝特、激素类避孕药，氨苯砜、安定、强力霉素、氟喹诺酮类(如环丙沙星)、氟哌啶醇、口服降糖药(磺酰脲)，左旋甲状腺素、美沙酮、麻醉性镇痛药，去甲替林、孕激素、奎林、茶碱、他克莫司、三环类抗抑郁药(阿米替林、去甲替林)和叠氮胸苷
佐米曲普坦片	口服避孕药	药效提高	与西咪替丁、口服避孕药合用时,也可使佐米曲普坦片的血药浓度增加
氟西汀	金丝桃素	药效提高，不良反应增加	圣·约翰草：同其它SSRIs一样，氟西汀和草药圣·约翰草（金丝桃素）可能发生药效学相互作用，可能会增加5-羟色胺能效应，如5-羟色胺综合征
茶碱氯化钠	克林霉素	药效提高，不良反应增加	与克林霉素、林可霉素及某些大环内酯类（红霉素、罗红霉素、克拉霉素）、喹诺酮类抗菌药（伊诺沙星、环丙沙星）合用时，可降低茶碱氯化钠在肝脏的清除率，使血药浓度升高，甚至出现毒性反应，应在给药前后调整茶碱氯化钠的用量
甲氨蝶呤	乙胺嘧啶	不良反应增加	氨苯喋啶，乙胺嘧啶等药物均有抗叶酸作用，如与甲氨蝶呤同用可增加其毒副作用；
环孢素软胶囊	利福平	药效降低	降低环孢素软胶囊血浆或全血浓度的有：巴比妥类药物、异烟肼、安乃近、卡马西平、苯妥英、Metamizole、利福平、萘夫西林、西咪替丁、磺胺二甲嘧啶注射剂、甲氧苄啶注射剂、曲格列酮、普罗布考、奥曲肽、贯叶连翘含有制剂、噻氯匹定
硝酸甘油氯化钠	双氢麦角胺	药效提高	据报道，当伴随使用双氢麦角胺时，硝酸甘油氯化钠能增加血液中的双氢麦角胺的水平，从而增加它的升血压效应
甲氧氯普胺	地高辛	药效降低	西咪替丁、慢溶型剂型地高辛同用，后者的胃肠道吸收减少，如间隔2小时服用可以减少这种影响；甲氧氯普胺还可增加地高辛的胆汁排出，从而改变其血浓度
棕榈氯霉素	麻醉药	药效提高	在术前或术中应用，由于棕榈氯霉素对肝酶的抑制作用，可降低诱导麻醉药阿芬他尼的清除，延长其作用时间
硝苯地平	奎尼丁	药效降低	奎尼丁:硝苯地平与奎尼丁同时服用时，奎尼丁浓度下降，或停服硝苯地平后，在个别的病例中奎尼丁的血药浓度明显升高
单硝酸异山梨酯Ⅳ	西地那非	药效提高，不良反应增加	和治疗勃起功能障碍的5型磷酸二酯酶抑制剂（如西地那非）合用会增加单硝酸异山梨酯Ⅳ的降压作用，可能引起致命的心血管并发症因此使用单硝酸异山梨酯Ⅳ时不能使用5型磷酸二酯酶抑制剂（如西地那非）
尼莫地平	西咪替丁	药效提高	当尼莫地平90mg/d与西咪替丁1000mg/d联合应用1周以上者，尼莫地平血药浓度可增加50%，这可能与后者抑制肝内细胞色素P450活性有关
米非司酮	红霉素	药效提高	其代谢有可能被酮康唑、伊曲康唑、红霉素和葡萄柚汁抑制（增加血清米非司酮水平）》此外，利福平、地塞米松、S.John麦芽汁和某些抗惊厥药（苯妥英、苯巴比妥、卡马西平）可能诱导米非司酮代谢（降低米非司酮血清水平）根据体外抑制资料，联合给予米非司酮可以导致本身是CYP3A4底物的药物血清水平增加，由于米非司酮从体内消除减慢，这种相互作用可以从给药后体内时间延长观察到
小诺霉素	盐酸四环素	药效降低，不良反应增加	小诺霉素不宜与两性霉素B、头孢噻吩钠、呋喃妥因钠、磺胺嘧啶钠和盐酸四环素等（以上均为注射液）联合应用，因可发生配伍禁忌
地奈德	炔雌醇	药效提高，不良反应增加	布地奈德的代谢转化可被由CYP3A4代谢的物质（例如伊曲康唑、酮康唑、利托那韦、奈非那韦、环孢素、炔雌醇和醋竹桃霉素）所抑制
非索非那定	红霉素	药效提高	盐酸非索非那定虽然表现出较小的肝脏代谢率（5%），但与红霉素、酮康唑作用时会导致盐酸非索非那定的血药浓度升高
异福酰胺	卡马西平	药效提高，不良反应增加	异福酰胺可抑制卡马西平的代谢，使其血药浓度增高，引起毒性反应；卡马西平则可诱导异烟肼的微粒体代谢，使具有肝毒性的中间代谢物增加
拉呋替丁颗粒	华法林	药效提高，不良反应增加	其它H2受体阻滞药能与细胞色素P450结合，从而降低肝微粒体药物代谢酶的活性，因此拉呋替丁颗粒与华法林、苯妥英钠、茶碱、苯巴比妥、安定或普奈洛尔和西米替丁合用时应注意
氟西泮	抗真菌药	药效提高，不良反应增加	氟西泮与抗真菌药酮康唑、伊曲康唑合用，可提高氟西泮疗效并增加其毒性
西沙必利	西柚汁	药效提高，不良反应增加	西沙必利与西柚汁同服时，引起西沙必利口服生物利用度增加约50％，建议尽量避免与西柚汁同服
哌拉西林	维库溴铵	药效提高	哌拉西林与维库溴铵合用可延长维库溴铵对神经肌肉的阻滞作用
贝诺酯	抗凝剂	药效提高	贝诺酯与口服抗凝剂同服可延长凝血酶原时间
奎宁	抗生素	药效提高，不良反应增加	酸药及含铝制剂能延缓或减少奎宁的吸收；②抗凝药与奎宁合用后，抗凝作用可增强；③肌肉松弛药如琥珀胆碱、筒箭毒碱等与奎宁合同，可能会引起呼吸抑制；④奎尼丁与奎宁合用，金鸡纳反应可增加；⑤尿液碱化剂如碳酸氢钠等，可增加肾小管对奎宁的重吸收，导致奎宁血药浓度与毒性的增加；⑥与维生素K合用可增加奎宁的吸收；⑦与布克利嗪、赛克利嗪、美克利嗪、吩噻嗪类、噻吨类、曲美苄胺（trimethofenzamide）、氨基苷类抗生素合用可导致耳鸣、眩晕；⑧与硝苯地平（硝苯啶）合用，游离的奎宁浓度增加
罗格列酮	西咪替丁	药效提高	虽然这种与阳离子药物（如，阿米洛利、地高辛、吗啡、普鲁卡因酰胺、奎尼丁、奎宁、雷尼替丁、氨苯喋啶、甲氧苄啶和万古霉素）的相互作用仍然是理论上的（西咪替丁除外），但使用经近端肾小管分泌系统排泄的阳离子药物的患者，用罗格列酮治疗时应当密切观察病情，调整罗格列酮和/或干扰药物的剂量
复方磺胺嘧啶	雌激素	药效降低，不良反应增加	与避孕药（口服含雌激素者），同时长时间应用复方磺胺嘧啶可导致避孕的可靠性减少，并增加经期外出血的机会
氟氯西林	丙磺舒	药效提高	氟氯西林和阿莫西林与丙磺舒同时使用时，可降低氟氯西林和阿莫西林的肾小管分泌作用，导致血药浓度升高和药物半衰期延长
复方对乙酰氨基酚	巴比妥类	不良反应增加	应用巴比妥类（如苯比妥）或解痉药（如颠茄）的患者，长期使用复方对乙酰氨基酚时可至肝脏损害，故不应同服
富马酸阿奇霉素片	地高辛	药效提高	地高辛：富马酸阿奇霉素片可以使地高辛水平升高
氨咖敏	抗胆碱药	药效提高	氨咖敏可增强金刚烷胺、抗胆碱药、氟哌啶醇、吩噻嗪类以及拟交感神经药等的作用
羧苄西林	苯妥英钠	药效降低，不良反应增加	羧苄西林与琥珀氯霉素、琥乙红霉素、盐酸土霉素、盐酸四环素、卡那霉素、链霉素、庆大霉素、妥布霉素、两性霉素B、维生素B族、维生素C、苯妥英钠、拟交感类药物、异丙嗪等有配伍禁忌
头孢噻肟舒巴坦	保泰松	药效提高，不良反应增加	丙磺舒、阿斯匹林、吲哚美辛、保泰松、磺胺等药物可减少舒巴坦自肾排泄，因此与头孢噻肟舒巴坦合用时使其血药浓度增高，排泄时间延长，毒性也可能增加
茶碱Ⅱ	克林霉素	药效提高，不良反应增加	克林霉素、林可霉素及某些大环内酯类（红霉素、罗红霉素、克拉霉素）、喹诺酮类抗菌药（伊诺沙星、环丙沙星）合用时，可降低茶碱Ⅱ在肝脏的代谢，血药浓度升高，甚至出现毒性，应在给药前后调整茶碱Ⅱ的用量
小儿碳酸钙D3颗粒	苯妥英钠	药效降低	小儿碳酸钙D3颗粒与苯妥英钠类及四环素类同用，二者吸收减低
非诺贝特	呋塞米	药效提高	非诺贝特与其它髙蛋白结合率的药物合用时，可使它们的游离型增加，药效增强，如甲苯磺丁脲及其它磺脲类降糖药、苯妥英、呋塞米等，在降血脂治疗期间服用上述药物，则应调整降糖药及其它药的剂量
阿利吉仑	ACEI	不良反应增加	阿利吉仑与其他作用于RAAS系统的药物，如ACEI或ARB类联合使用时，与单药治疗相比，可导致低血压、高钾血症的风险增加和肾功能（包括急性肾衰竭）的改变
丙胺太林	地高辛	药效提高	如红霉素可因在胃内停留过长而受到胃酸分解，降低疗效，对乙酰氨基酚的吸收可被延迟，血浆峰浓度降低；地高辛的血浆浓度可因同用丙胺太林而提高
硝西泮片	钙离子	药效提高，不良反应增加	硝西泮片与钙离子通道拮抗药合用时，可使低血压加重
辛伐他汀	烟酸	不良反应增加	辛伐他汀与甲基羟戊二酰辅酶A（HMG-CoA）还原酶抑制剂合并用药会增加肌病的发生率和严重程度，这些药物包括吉非贝齐和其他贝特类，以及降脂剂量的烟酸（大于等于1g/d）
黄体酮	苯妥英钠	药效降低	苯巴比妥、苯妥英钠、利福平等药物由于对细胞色素P450具有诱导作用，可以削弱黄体酮的药效
酒石酸西尼必利片	抗胆碱能药物	药效降低	阿托品样的抗胆碱能药物和阿片类镇痛药物可能会削弱酒石酸西尼必利片对消化道的作用
利托那韦	苯妥因	药效降低	苯巴比妥、卡马西平、苯妥因和利福平能增加CYP3A4的活性，很可能与利托那韦发生相互作用，增加利托那韦的清除，降低利托那韦的活性
苯妥英	对乙酰氨基酚	药效降低，不良反应增加	长期应用对乙酰氨基酚患者应用苯妥英可增加肝脏中毒的危险，并且疗效降低
文拉法辛	美托洛尔	药效提高	一项药代动力学研究中,同时给予健康志愿者文拉法辛(每8小时给予50mg连续5天)和美托洛尔[每24小时给予100mg连续5天)，显示美托洛尔的血药浓度升高约30-40%，而其活性代谢产物α-羟基美托洛尔的血药浓度没有受到影响
复方溴丙胺太林	阿托品	不良反应增加	奎尼丁和复方溴丙胺太林同用，其类似阿托品样的效应加重
毒毛花苷K	肝素	药效降低	与肝素同用，由于毒毛花苷K可能部分抵消肝素的抗凝作用，需调整肝素用量
舒巴坦	吲哚美辛	药效提高，不良反应增加	丙磺舒、阿斯匹林、吲哚美辛、保泰松、磺胺等药物可减少舒巴坦自肾排泄，因此与舒巴坦合用时使其血药浓度增高，排泄时间延长，毒性也可能增加
氟康唑氯化钠	氢氯噻嗪	药效提高	氟康唑氯化钠与氢氯噻嗪合用，可使氟康唑氯化钠的血药浓度升高
丙戊酸	奎宁	不良反应增加	癫痫患者联合服用时，由于美尔奎宁可能导致丙戊酸代谢增加及自身的诱导发作的作用可使其存在癫痫发作的风险
阿立哌唑	氟西汀	药效提高	CYP3A4抑制剂（如酮康唑）或CYP2D6抑制剂（如：奎尼丁、氟西汀、帕罗西汀）可以抑制阿立哌唑的消除，使血药浓度升高
盐酸加替沙星胶囊	硫酸亚铁	药效降低	硫酸亚铁、含铝或镁制酸剂和去羟基苷(地丹诺辛、惠妥兹)与盐酸加替沙星胶囊合用，加替沙星的生物利用度会降低
氨氯地平	酮康唑	药效提高	无法排除更强效的CYP3A4抑制剂（即酮康唑、伊曲康唑、利托那韦）会使氨氯地平血浆浓度的升高程度大于地尔硫卓这一可能性
西咪替丁	阿司匹林	药效降低	由于西咪替丁使胃液pH值升高，与四环素合用时，可致四环素的溶解速率下降、吸收减少、作用减弱（但西咪替丁的肝药酶抑制作用却可能增加四环素的血药浓度）；若与阿司匹林合用，则出现相反的结果，可使阿司匹林的作用增强
辛伐他汀	免疫抑制剂	不良反应增加	辛伐他汀与免疫抑制剂如环孢素、红霉素、吉非罗齐、盐酸等合用可增加肌溶解和急性肾功能衰竭发生的危险
曲马多	帕罗西汀	药效提高	在人肝微粒体中进行的体外药物相互作用研究显示，与CYP2D6酶抑制剂(如氟西汀、帕罗西汀和阿米替林)同时服用，可能抑制曲马多的代谢
雷贝拉唑	地高辛	药效降低	例如，正常受试者如果每天同时服用酮康唑与20mg雷贝拉唑钠，会使酮康唑的生物利用度减少大约30％；同时服用地高辛，会使地高辛的AUC和Cmax值分别增加19％和29％
单硝酸异山梨酯	麻黄碱	药效降低	拟交感神经类药（如肾上腺素、去甲肾上腺素或麻黄碱等）可降低单硝酸异山梨酯的抗心绞痛效应
依非韦伦	环孢霉素A	药效降低	由CYP3A4代谢的免疫抑制剂（比如环孢霉素A、他克莫司或西罗莫司）与依非韦伦同时服用时，由于CYP3A4的减少可能发生免疫抑制剂暴露量的减少
氯化钠	氟尿嘧啶	药效降低，不良反应增加	氯化钠与碱性注射液(如呋喃苯胺酸、甲氨蝶呤、氟尿嘧啶、吡咯他尼注射液)或鬼臼乙叉甙注射液配伍会发生浑浊或结晶析出，应避免配伍使用
多维铁口服溶液	左旋多巴	药效降低	多维铁口服溶液可减少左旋多巴、卡比多巴、甲基多巴及喹诺酮类药物的吸收
培氟沙星	华法林	药效提高	培氟沙星与抗凝药华法林同用时可增强后者的抗凝作用合用时应严密监测患者的凝血酶原时间，并调整剂量
重组人粒细胞巨噬细胞刺激因子	化疗药物	不良反应增加	重组人粒细胞巨噬细胞刺激因子与化疗药物同时使用，可加重骨髓毒性，因而不宜与化疗药物同时使用，应于化疗结束后24～48小时使用
美洛昔康片	消胆胺	药效降低	在胃肠道中消胆胺与美洛昔康片可结合可加快美洛昔康的排除
克拉维酸钾	阿司匹林	药效提高，不良反应增加	．阿司匹林、吲哚美辛、保泰松、磺胺药可减少克拉维酸钾在肾小管的排泄，因而使克拉维酸钾的血药浓度升高，血消除半衰期（t1/2β）延长，毒性也可能增加
阿莫西林克拉维酸钾	别嘌呤醇	不良反应增加	虽然尚无阿莫西林克拉维酸钾与别嘌呤醇合用的资料，但阿莫西林与别嘌呤醇合用可增加过敏性皮肤反应的可能性
雷尼替丁	吉非替尼	药效提高	雷尼替丁影响胃内pH值，从而可能导致药物的吸收增加（例如三唑仑，咪达唑仑，格列吡嗪）或吸收减少（例如酮康唑，阿扎那韦，地拉夫定，吉非替尼）
利多卡因	西咪替丁	药效提高，不良反应增加	与西咪替丁以及与β受体阻滞剂如，普萘洛尔、美托洛尔、纳多洛尔合用，利多卡因经肝脏代谢受抑制，利多卡因血浓度增加，可发生心脏和神经系统不良反应．应调整利多卡因剂量，并应心电图监护及监测利多卡因血药浓度
青霉素	丙磺舒	药效提高	丙磺舒竞争性地减少青霉素的肾小管分泌，两者同时应用可引起阿莫西林血浓度升高、半衰期延长
酮康唑	苄普地尔	不良反应增加	-由于酮康唑与CYP3A4底物合用会增加这些药物的血浆浓度，而可能导致QT间期延长和个别出现尖端扭转型室速，因此酮康唑禁止与下列药物合用：特非那丁、苄普地尔、阿司咪唑、卤泛群、左醋美沙朵(左美沙酮)、咪唑斯汀、西沙必利、多非利特、奎尼丁、匹莫齐特、苯丙胺、舍吲哚；
洋地黄毒苷	肝素	药效降低	肝素同用，由于洋地黄毒苷可能部分抵消肝素的抗凝作用，需调整肝素用量；
地巴唑	酮康唑	药效提高，不良反应增加	地巴唑与抗真菌药酮康唑、伊曲康唑合用，可提高地巴唑疗效并增加其毒性
更昔洛韦	氨苯砜	不良反应增加	抑制高分裂相细胞(骨髓、精原细胞、皮肤和胃肠道粘膜生发层)复制的药物(氨苯砜、喷他脒、氟胞嘧啶、长春新碱、长春花碱、阿霉素、两性霉素B、甲氧苄啶/磺胺恶唑或其他核苷类)与更昔洛韦合用时毒性增加
注射用亚胺培南西司他丁钠	更昔洛韦	不良反应增加	注射用亚胺培南西司他丁钠与更昔洛韦同时使用有癫痫全身发作的报道
西索米星	磺胺嘧啶	药效降低，不良反应增加	西索米星不宜与两性霉素B、头孢噻吩钠、呋喃妥因钠，磺胺嘧啶钠和四环素（以上均为注射液）联合应用，因可发生配伍禁忌
肝素	万古霉素	药效降低，不良反应增加	下列药物与肝素有配伍禁忌：卡那霉素、阿米卡星、柔红霉素、乳糖酸红霉素、硫酸庆大霉素、氢化考的松琥珀酸钠、多粘菌素B、阿霉素、妥布霉素、万古霉素、头孢孟多、头孢氧哌唑、头孢噻吩钠、氯喹、氯丙嗪、异丙嗪、麻醉性镇痛药
单硝酸异山梨酯	西地那非	药效提高，不良反应增加	和治疗勃起机能障碍的西地那非合用会增加单硝酸异山梨酯的降压作用，可能引起致命的心血管并发症，因此使用单硝酸异山梨酯时不能使用西地那非
布洛伪麻混悬液	口服降糖药	药效提高，不良反应增加	布洛伪麻混悬液与地高辛、甲氨喋呤、口服降糖药同时服用，能使这些药物的血药浓度增高，不良反应增加
己酮可可碱	降压药	药效提高	己酮可可碱可增强降压药、降糖药及抗凝药的作用
西索米星	磺胺嘧啶	药效降低，不良反应增加	西索米星不宜与两性霉素B、头孢噻吩钠、呋喃妥因钠、磺胺嘧啶钠和四环素等(以上均为注射液)联合应用，因可发生配伍禁忌
睾丸片	双香豆素	药效提高	在与双香豆素类或茚满二酮衍生物合用时要减少睾丸片用量，因雄激素可降低凝血因子前体浓度，可使抗凝药作用增强
谷氨酸诺氟沙星	华法林	药效提高	谷氨酸诺氟沙星与抗凝药华法林同用时可增强后者的抗凝作用，合用时应严密监测患者的凝血酶原时间
右旋糖酐铁口服溶液	喹诺酮类	药效降低	右旋糖酐铁口服溶液可减少左旋多巴、卡比多巴、甲基多巴及喹诺酮类药物的吸收；4.如正在服用其它药品，使用右旋糖酐铁口服溶液前请咨询医师或药师
辛伐他汀	细胞色素P4503A4	不良反应增加	当辛伐他汀与其它在治疗剂量下对细胞色素P4503A4有明显抑制作用的药物（如：环孢霉素、米贝地尔、伊曲康唑、酮康唑、红霉素、克拉霉素和奈法唑酮）或纤维酸类衍生物或盐酸合用时，导致横纹肌溶解的危险性增高
肌苷氯化钠注射液	促皮质素	药效降低，不良反应增加	肌苷氯化钠注射液禁与下列注射液配伍：乳清酸、氯霉素、双嘧达莫、盐酸山梗菜碱、硫酸阿托品、氢溴酸东莨菪碱、盐酸氯丙嗪、盐酸异丙嗪、马来酸麦角新碱、盐酸普鲁卡因、硫喷妥钠、苯妥英钠、氯氮卓、盐酸去甲肾上腺素、盐酸丁卡因、利血平、硝普钠、降压嗪、呋噻米、利尿酸钠、促皮质素、维生素B12、盐酸苯海拉明、马来酸氯苯那敏、细胞色素C、盐酸万古霉素、盐酸四环素、二盐酸奎宁、盐酸阿糖胞苷、硫酸长春新碱以及所有菌苗和疫苗
重组人粒细胞巨噬细胞刺激因子	化疗药物	不良反应增加	重组人粒细胞巨噬细胞刺激因子与化疗药物同时使用，可加重骨髓毒性，因而不宜与化疗药物同时使用，应于化疗结束后24-48小时使用
米非司酮	利福平	药效降低	此外，利福平、地塞米松、S.John，麦芽汁和某些抗惊厥药（苯妥英、苯巴比妥、卡马西平）可能诱导米非司酮代谢（降低米非司酮血清水平）
司帕沙星	镁	药效降低	司帕沙星与含有铝、镁、铁的抗酸药和硫糖铝合用时，可降低司帕沙星的吸收，从而降低药效，如需服用应间隔4小时
埃索美拉唑	酮康唑	药效降低	与使用其他泌酸抑制剂或抗酸药一样，埃索美拉唑治疗期间酮康唑和依曲康唑的吸收会降低
氟西汀	金丝桃素	不良反应增加	圣·约翰草：同其它SSRI-样，氟西汀和草药圣·约翰草(金丝桃素)可能发生药效学相互作用，这会导致不良反应增加
维拉帕米	阿霉素	药效提高	维拉帕米可增加卡马西平、环胞素、阿霉素、茶碱的血药浓度
加替沙星	硫酸亚铁	药效降低	硫酸亚铁、含铝或镁制酸剂和去羟基苷(地丹诺辛、惠妥兹)与加替沙星合用，加替沙星的生物利用度会降低
水杨酸	抗酸药	药效降低	抗酸药如碳酸氢钠等可增加水杨酸自尿中的排泄，使血药浓度下降，不宜同用；
氯丙嗪异丙嗪	苯巴比妥	药效降低	抗酸剂可以降低氯丙嗪异丙嗪的吸收，苯巴比妥可加快其排泄，因而减弱其抗精神病作用
复方卡比多巴	甲基多巴	药效提高，不良反应增加	复方卡比多巴与甲基多巴合用，可增加复方卡比多巴的不良反应并使甲基多巴的抗高血压作用增强
甲氨蝶呤	新霉素	药效降低	口服卡那霉素可增加口服甲氨蝶呤的吸收，而口服新霉素钠可减少其吸收；
复方对乙酰氨基酚Ⅱ	抗凝药	药效提高	大量或长期应用复方对乙酰氨基酚Ⅱ时，因可减少凝血因子在肝内的合成，有增强抗凝药的作用，故抗凝药的用量应根据情况进行调整
左奥硝唑	奥美拉唑	药效降低，不良反应增加	文献报道，奥硝唑与呋布西林钠、萘夫西林钠、奥美拉唑、沃必唑、注射用炎琥宁、阿洛西林钠存在配伍禁忌，左奥硝唑在使用时也应注意
阿利吉仑片	西米替丁	药效降低	当阿利吉仑片与以下药物联合使用时，可见阿利吉仑的Cmax或AUC出现20-30％的改变：缬沙坦（降低28％）、二甲双胍（降低28％）、氨氯地平（升高29％）和西米替丁（升高19％）
盐酸罗匹尼罗缓释片	苯丁酮类	药效降低	由于罗匹尼罗是一种多巴胺激动剂，多巴胺拮抗剂如精神安定类药（酚噻嗪类、苯丁酮类和硫杂蒽类）或甲氧氯普胺可降低盐酸罗匹尼罗缓释片的疗效
注射用埃索美拉唑钠	苯妥英	药效提高	CYP2C19是埃索美拉唑的主要代谢酶，故当注射用埃索美拉唑钠与经CYP2C19代谢的药物(如地西泮、西酞普兰、丙米嗪、氯米帕明、苯妥英等)合用时，这些药物的血浆浓度可被升高，可能需要降低剂量
哌嗪	氯丙嗪	不良反应增加	哌嗪与氯丙嗪同用有可能引起抽搐，故应避免合用
磺胺嘧啶	磺吡酮	药效提高，不良反应增加	磺吡酮与磺胺嘧啶合用时可减少磺胺嘧啶自肾小管的分泌，导致血药浓度的升高而持久或产生毒性，因此在应用磺吡酮期间或应用其治疗后可能需要调整磺胺嘧啶的剂量
酮康唑	奈韦拉平	药效降低	酶诱导药物，如利福平、利福布丁、卡马西平、异烟肼、奈韦拉平和苯妥英，会明显降低酮康唑的生物利用度而降低疗效
盐酸二甲双胍缓释胶囊	口服避孕药	药效降低	其它：会导致高血糖的药物与盐酸二甲双胍缓释胶囊合用时，如皮质类固醇、甲状腺素、雌激素、口服避孕药、尼古丁酸、钙离子通道阻滞剂、苯巴比妥类等，可能会使血糖控制失调，应密切监测血糖情况，停止上述药物时，也应密切监测低血糖情况
米氮平	利福平	药效降低	当苯妥英，卡马西平或其他的肝代谢诱导剂(如利福平)与米氮平同用时，米氮平的剂量可能需要增加
维生素B12	秋水仙碱	药效降低	氨基糖苷类抗生素、对氨基水杨酸类、苯巴比妥、苯妥英钠、扑米酮等抗惊厥药及秋水仙碱等可减少维生素B12从肠道的吸收
林可霉素氯化钠	阿片	不良反应增加	与阿片类镇痛药合用，林可霉素氯化钠的呼吸抑制作用与阿片类的中枢呼吸抑制作用可因累加现象而有导致呼吸抑制延长或引起呼吸麻痹（呼吸暂停）的可能，故必须对病人进行密切观察或监护
土霉素片(糖衣片)	镁	药效降低	含钙、镁、铁等金属离子的药物，可与土霉素片(糖衣片)形成不溶性络合物，使土霉素片(糖衣片)吸收减少
萘普生	呋塞米	药效降低	普生可降低呋塞米的排钠和降压作用
美洛西林	华法林	药效提高	美洛西林可加强华法林的作用
普萘洛尔	异烟肼	药效提高，不良反应增加	与抗凝剂如香豆素类或氯霉素、异烟肼、保泰松、磺胺类合用，可减低普萘洛尔的代谢，可能增加普萘洛尔的毒性
阿莫西林克拉维酸	保泰松	药效提高，不良反应增加	．阿司匹林、吲哚美辛、保泰松、磺胺药可减少阿莫西林克拉维酸在肾小管的排泄，因而使阿莫西林克拉维酸的血药浓度升高，血消除半衰期（t1/2β）延长，毒性也可能增加
辛伐他汀	达那唑	不良反应增加	环抱菌素或达那唑：同时与环抱菌素或达那唑合用会增加肌病/横纹肌溶解的危险，特别是与大剂量辛伐他汀合用时（见注意事项，肌病/横纹肌溶解）
甲硝唑维B6	苯巴比妥	药效降低	同时应用苯妥英钠，苯巴比妥等诱导肝微粒体酶的药物，可加强甲硝唑维B6代谢，使血药浓度下降，而苯妥英钠排泄减慢
氯烯雌醚	扑米酮	药效降低	与苯巴比妥、苯妥英钠、扑米酮合用，可使氯烯雌醚作用降低
奎宁	琥珀胆碱	药效提高，不良反应增加	酸药及含铝制剂能延缓或减少奎宁的吸收；②抗凝药与奎宁合用后，抗凝作用可增强；③肌肉松弛药如琥珀胆碱、筒箭毒碱等与奎宁合同，可能会引起呼吸抑制；④奎尼丁与奎宁合用，金鸡纳反应可增加；⑤尿液碱化剂如碳酸氢钠等，可增加肾小管对奎宁的重吸收，导致奎宁血药浓度与毒性的增加；⑥与维生素K合用可增加奎宁的吸收；⑦与布克利嗪、赛克利嗪、美克利嗪、吩噻嗪类、噻吨类、曲美苄胺（trimethofenzamide）、氨基苷类抗生素合用可导致耳鸣、眩晕；⑧与硝苯地平（硝苯啶）合用，游离的奎宁浓度增加
利福平	降血糖药	药效降低	肾上腺皮质激素（糖皮质激素、盐皮质激素）、抗凝药、香豆素或茚满二酮衍生物、口服降血糖药、促皮质激素、氨苯砜、洋地黄苷类、丙吡胺、奎尼丁等与利福平合用时，由于后者对肝微粒体酶活性的刺激作用，可使上述药物的药效减低，因此除地高辛和氨苯砜外，在用利福平前和疗程中上述药物需调整剂量
酮康唑	匹莫齐特	不良反应增加	-由于酮康唑与CYP3A4底物合用会增加这些药物的血浆浓度，而可能导致QT间期延长和个别出现尖端扭转型室速，因此酮康唑禁止与下列药物合用：特非那丁、苄普地尔、阿司咪唑、卤泛群、左醋美沙朵(左美沙酮)、咪唑斯汀、西沙必利、多非利特、奎尼丁、匹莫齐特、苯丙胺、舍吲哚；
茚地那韦	依非韦伦	药效降低	当茚地那韦以加大的剂量（每8小时1000毫克）与依非韦伦（每日一次600毫克）合用于未被感染的志愿者时，与单独服用茚地那韦标准剂量（每8小时800毫克）相比，茚地那韦的AUC，Cmax和Cmin大约分别减少了33-46%，5-29%和39-57%
罗格列酮	雷尼替丁	药效提高	虽然这种与阳离子药物（如，阿米洛利、地高辛、吗啡、普鲁卡因酰胺、奎尼丁、奎宁、雷尼替丁、氨苯喋啶、甲氧苄啶和万古霉素）的相互作用仍然是理论上的（西咪替丁除外），但使用经近端肾小管分泌系统排泄的阳离子药物的患者，用罗格列酮治疗时应当密切观察病情，调整罗格列酮和/或干扰药物的剂量
氨酚帕马溴	安定	药效提高	氨酚帕马溴与中枢神经系统抑制剂（如安定）合用时有强化镇静作用和镇痛作用，应适当减量，与巴比妥类药物合用可延长麻醉时间
橙皮	肝素	药效降低	橙皮与肝素或华法林联用，可引起凝血时间缩短
卡马西平	洛沙平	药效降低	氟哌啶醇、洛沙平、马普替林、噻嗪类或三环类抗抑郁药可增强卡马西平对中枢神经的抑制，降低惊厥阈，从而降低抗惊厥药的疗效，需调整用量以控制癫痫发作
瑞舒伐他汀	抗酸药	药效降低	抗酸药：同时给予瑞舒伐他汀和一种含氢氧化铝镁的抗酸药混悬液，可使瑞舒伐他汀的血浆浓度降低约50%
利福平Ⅱ	酮康唑	药效降低	利福平与咪康唑或酮康唑合用，可使后两者血药浓度减低，故利福平Ⅱ不宜与咪唑类合用
奎宁	硝苯地平	药效提高	硝苯地平(硝苯啶)合用，游离的奎宁浓度增加;
他唑巴坦	复方乳酸钠注射液	药效降低，不良反应增加	他唑巴坦与复方乳酸钠注射液或盐酸利多卡因注射液混合后出现配伍禁忌
西酞普兰	丁螺环酮	不良反应增加	药效学上，西酞普兰与吗氯贝胺和丁螺环酮合用时，已经报告了有病例出现5-羟色胺综合症
齐多夫定	氟胞嘧啶	不良反应增加	与具有潜在肾毒性或骨髓抑制作用的药物，如全身用喷他咪、氨苯砜、乙胺嘧啶、复方磺胺甲恶唑、两性霉素、氟胞嘧啶、更昔洛韦、干扰素、长春花碱及阿霉素同时应用，特别在急性期治疗时亦可以使齐多夫定产生不良反应的机率增加
维生素C+E	华法令	药效降低	维生素C+E与肝素或华法令联用，可引起凝血酶原时间缩短
氢氯噻嗪	噻嗪类利尿剂	药效提高	维生素D：联合使用噻嗪类利尿剂（包括氢氯噻嗪）与维生素D或钙盐可引起血钙升高
氯普噻吨	苯丙胺	药效降低	氯普噻吨与苯丙胺合用，可降低后者的效应
肌苷氯化钠注射液	盐酸氯丙嗪	药效降低，不良反应增加	肌苷氯化钠注射液禁与下列注射液配伍：乳清酸、氯霉素、双嘧达莫、盐酸山梗菜碱、硫酸阿托品、氢溴酸东莨菪碱、盐酸氯丙嗪、盐酸异丙嗪、马来酸麦角新碱、盐酸普鲁卡因、硫喷妥钠、苯妥英钠、氯氮卓、盐酸去甲肾上腺素、盐酸丁卡因、利血平、硝普钠、降压嗪、呋噻米、利尿酸钠、促皮质素、维生素B12、盐酸苯海拉明、马来酸氯苯那敏、细胞色素C、盐酸万古霉素、盐酸四环素、二盐酸奎宁、盐酸阿糖胞苷、硫酸长春新碱以及所有菌苗和疫苗
利多卡因Ⅱ	普萘洛尔	药效提高，不良反应增加	与西咪替丁以及β受体阻断剂如，普萘洛尔、美托洛尔、纳多洛尔合用，利多卡因经肝脏代谢受抑制，利多卡因血浓度增加，可发生心脏和神经系统不良反应，应调整利多卡因剂量，并应心电图监护及监测利多卡因血药浓度；(2)巴比妥类药物可促进利多卡因代谢，两药合用可引起心动过缓，窦性停搏；(3)与普鲁卡因胺合用，可产生一过性谵妄及幻觉，但不影响利多卡因Ⅱ血药浓度；(4)异丙基肾上腺素因增加肝血流量，可使利多卡因Ⅱ的总清除率升高；去甲肾上腺素因减少肝血流量，可使利多卡因Ⅱ总清除率下降；(5)与下列药品有配伍禁忌：苯巴比妥，硫喷妥钠，硝普钠，甘露醇，两性霉素B，氨苄西林，磺胺嘧啶
氢溴酸加兰他敏口腔崩解片	地高辛	不良反应增加	有报道氢溴酸加兰他敏口腔崩解片与地高辛合用时可出现房室传导阻滞
卡马西平	锂	药效降低	锂可降低卡马西平的抗利尿作用
甲氨蝶呤	丙磺舒	药效提高，不良反应增加	由于丙磺舒和弱有机酸（如：髓袢利尿剂和吡唑）可减少肾小管分泌，因此这些药物与甲氨蝶呤合用时须非常谨慎
咪康唑	苯妥英钠	药效降低	苯妥英钠与咪康唑合用可引起两种药物低谢改变，并使咪康唑的达峰时间延迟，两药合用时应严密观察其反应
布洛芬	甲氨蝶呤	药效提高，不良反应增加	布洛芬可降低甲氨蝶呤的排泄，增加其血药浓度，甚至可达中毒水平，故布洛芬不应与中或大剂量甲氨蝶呤同用
维生素D滴剂	降压药	不良反应增加	大剂量钙剂或利尿药（一些降压药）与维生素D滴剂同用，可能发生高钙血症
西咪替丁	维拉帕米	药效提高，不良反应增加	西咪替丁可使维拉帕米(异搏定)的绝对生物利用度由26.3%±16.8%提高到49.3%±23.6%，由于维拉帕米可发生少见但很严重的副作用，因此应引起注意
阿洛西林	吲哚美辛	药效提高，不良反应增加	丙磺舒、阿司匹林、吲哚美辛、保泰松、磺胺药可减少阿洛西林自肾脏排泄，因此与阿洛西林合用时使其血药浓度增高，排泄时间延长，毒性也可能增加
普鲁卡因	西咪替丁	药效降低	降压药合用，尤其静注普鲁卡因时，降压作用可增强；④与拟胆碱药合用时，普鲁卡因可抑制这类药对横纹肌的效应；⑤与神经肌肉阻滞剂（包括去极化型和非去极化型阻滞剂）合用时，神经肌肉接头的阻滞作用增强，时效延长；⑥酒精可以增加该药的清除率，缩短其半衰期；⑦抗酸药物可以降低其生物利用度，因此不建议两者合用；⑧西咪替丁可以降低普鲁卡因胺和N-乙酰普鲁卡因胺的肾清除率，因此两药合用时需减低普鲁卡因胺的用量；⑨雷尼替丁可影响该药在肾脏的代谢，合用时注意调整用量；⑩甲氧苄啶可以降低普鲁卡因胺和N-乙酰普鲁卡因胺的肾清除率，合用时需减低普鲁卡因胺的用量
替米沙坦	降压药	药效提高	其他的降压药：替米沙坦的降低血压的效果可被其它降压药的伴随使用增加
维帕他韦	圣约翰草	药效降低	P-gp强效诱导剂或CYP2B6、CYP2C8或CYP3A4强效诱导剂类药品（例如利福平、利福布丁、圣约翰草、卡马西平、苯巴比妥和苯妥英）可能会降低索磷布韦、维帕他韦和/或伏西瑞韦的血药浓度，从而导致索磷维伏片的疗效降低
桂利嗪	酒精	不良反应增加	当桂利嗪与酒精、催眼药或镇静药合用时可出现过度镇静作用
头孢克洛	丙磺舒	药效提高	与其他B-内酰胺类相同，丙磺舒抑制头孢克洛经肾小管分泌排泄，并推测头孢克洛缓释片亦为如此
鱼肝油乳	新霉素	药效降低	考来烯胺、矿物油、新霉素、硫糖铝能干扰鱼肝油乳中维生素A的吸收
氟哌啶	苯丙胺	药效降低	氟哌啶与苯丙胺合用，可降低后者的作用
尼群地平	西咪替丁	药效提高	西咪替丁：由于西咪替丁可介导抑制肝脏细胞色素P450酶，使尼群地平的首过效应发生改变，建议对正在服用西咪替丁治疗的患者合用尼群地平时，注意药物剂量的调整
非洛地平	苯妥英	药效降低	细胞色素P450诱导剂：卡马西平、苯妥英、苯巴比妥和利福平等P450诱导剂能增加非洛地平的代谢
氟康唑葡萄糖	西沙必利	不良反应增加	氟康唑葡萄糖与西沙必利同时使用可能出现心脏不良反应，包括尖端扭转型心动过速
对乙酰氨基酚	颠茄	不良反应增加	应用巴比妥类（如苯巴比妥）或解痉药（如颠茄）的患者，长期应用对乙酰氨基酚可致肝损害
文拉法辛	利奈唑胺	不良反应增加	类似其它5-羟色胺能药物，使用文拉法辛治疗时，可能发生5-羟色胺综合征(一种有潜在生命威胁的情况)，尤其是在与以下药物合并使用时：其它作用于5-羟色胺递质系统的药物(包括曲坦、SSRIs、其它SNRIs、锂盐、西布曲明、曲马多或圣约翰草[金丝桃属植物提取物])，损害5-羟色胺代谢的药物如MAOIs，包括利奈唑胺[一种抗生素，是可逆性、非选择性的MAOI见[禁忌])，或5-羟色胺前体(如：色氨酸补充剂)
利托那韦口服溶液	氯拉折帕	不良反应增加	阿普唑仑、安非他酮、胺碘酮、阿咪唑、苄替地尔、西沙必利、氯拉折帕、氯氮平、右丙氧芬、地西泮、二氢麦角胺、恩卡肢、舒乐安定、麦角胺、氟卡胺、氟西泮、咪达唑仑、哌替啶、匹莫齐特、吡罗昔康、普罗帕酮、奎尼丁、利福布丁、特非那定、三唑仑和左吡登禁止用于利托那韦口服溶液治疗的病人，因为它们可能与利托那韦口服溶液发生相互作用，产生严重并发症的危险
叶酸	甲氨喋呤	药效降低	因此高剂量的亚叶酸可能降低甲氨喋呤鞘内给药的效果
醋酸钙片	噻嗪类利尿药	不良反应增加	醋酸钙片与噻嗪类利尿药和用时，易发生高血钙血症（因增加肾小管对钙的重吸收）
依非韦伦	利福布丁	药效降低	一项在未感染HIV的志愿者中进行的研究表明，依非韦伦可分别减少利福布丁的Cmax32%和AUC38%，并增加利福布丁的清除率
伪麻那敏	呋塞米	药效降低	伪麻那敏与呋塞米（呋喃苯胺酸）合用时，后者的排钠和降压作用减弱，与抗高血压药合用时，会降低降压效果
利多卡因	西咪替丁	药效提高，不良反应增加	与西咪替丁以及β受体阻断剂如，普萘洛尔、美托洛尔、纳多洛尔合用，利多卡因经肝脏代谢受抑制，利多卡因血浓度增加，可发生心脏和神经系统不良反应，应调整利多卡因剂量，并应心电图监护及监测利多卡因血药浓度；(2)巴比妥类药物可促进利多卡因代谢，两药合用可引起心动过缓，窦性停搏；(3)与普鲁卡因胺合用，可产生一过性谵妄及幻觉，但不影响利多卡因血药浓度；(4)异丙基肾上腺素因增加肝血流量，可使利多卡因的总清除率升高；去甲肾上腺素因减少肝血流量，可使利多卡因总清除率下降；(5)与下列药品有配伍禁忌：苯巴比妥，硫喷妥钠，硝普钠，甘露醇，两性霉素B，氨苄西林，磺胺嘧啶
利多卡因	西米替丁	药效提高，不良反应增加	与西米替丁以及与β受体阻断剂如：普萘洛尔、美托洛尔、纳多洛尔合用，利多卡因经肝脏代谢受抑制，利多卡因血浓度增加，可发生心脏和神经系统不良反应，应调整利多卡因剂量，并应心电图监护及监测利多卡因血药浓度
班布特罗	奎尼丁	药效提高	由于奎尼丁即使在治疗剂量也可以抑制胆碱酯酶，理论上奎尼丁可以抑制班布特罗降解
利托那韦	安非他酮	不良反应增加	阿普唑仑、安非他酮、胺碘酮、阿咪唑、苄替地尔、西沙必利、氯拉折帕、氯氮平、右丙氧芬、地西泮、二氢麦角胺、恩卡肢、舒乐安定、麦角胺、氟卡胺、氟西泮、咪达唑仑、哌替啶、匹莫齐特、吡罗昔康、普罗帕酮、奎尼丁、利福布丁、特非那定、三唑仑和左吡登禁止用于利托那韦治疗的病人，因为它们可能与利托那韦发生相互作用，产生严重并发症的危险
复方地巴唑氢氯噻嗪	间羟胺	药效降低，不良反应增加	与拟交感类药同用使复方地巴唑氢氯噻嗪的降压作用减弱，也可使拟交感类药的升压作用增强，间羟胺与复方地巴唑氢氯噻嗪同用可至高血压危象
丙泊酚乳状注射液	苯二氮卓类药物	药效提高，不良反应增加	据报告丙泊酚乳状注射液与苯二氮卓类药物、副交感神经阻滞剂或吸入麻醉药合用时，可延长麻醉时间并降低呼吸频率
普萘洛尔	利扎曲普坦	药效提高	与普萘洛尔合用，佐米曲普坦的AUC增加56%，Cmax增加37%，利扎曲普坦的AUC和Cmax分别增加67%和75%
利福平	地西泮	药效降低	利福平与地西泮（安定）合用可增加后者的清除，使其血药浓度减低，故需调整剂量
缬沙坦	利福平	药效提高	合并使用摄取性转运蛋白抑制剂（例如，利福平，环孢素）或者外排性转运蛋白抑制剂（例如，利托那韦）可能会增加缬沙坦的全身暴露量
阿莫西林	阿司匹林	药效提高，不良反应增加	．阿司匹林、吲哚美辛、保泰松、磺胺药可减少阿莫西林在肾小管的排泄，因而使阿莫西林的血药浓度升高，血消除半衰期（t1/2β）延长，毒性也可能增加
氯霉素	苯巴比妥	药效降低	苯巴比妥、利福平等肝药酶诱导剂与氯霉素同用时，可增强氯霉素的代谢，致甲砜霉素血药浓度降低
异丙托溴铵气雾剂	β-肾上腺素能兴奋剂	药效提高	使用β-肾上腺素能兴奋剂或黄嘌呤类制剂(如茶碱)可加强异丙托溴铵气雾剂的作用
利福平滴眼液	促皮质素	药效降低	肾上腺皮质激素(糖皮质激素﹑盐皮质激素)﹑抗凝药﹑氨茶碱﹑茶碱﹑氯霉素﹑氯贝丁酯﹑环胞素﹑维拉帕米(异搏定)﹑妥卡尼﹑普罗帕酮﹑甲氧苄啶﹑香豆素或茚满二酮衍生物﹑口服降血糖药﹑促皮质素﹑氨苯砜﹑洋地黄苷类﹑丙吡胺﹑奎尼丁等与利福平合用时，由于后者诱导肝微粒体酶活性，可使上述药物的药效减弱，因此除地高辛和氨苯砜外，在用利福平前和疗程中上述药物需调整剂量，利福平滴眼液与香豆素或茚满二酮类合用时应每日或定期测定凝血酶原时间，据以调整剂量
西索米星	青霉素	药效降低	西索米星与β-内酰胺类(头孢菌素类或青霉素类)混合可导致相互失活，需联合应用时必须分瓶注射
他唑巴坦	青霉素	药效提高	与其他青霉素类相似，哌拉西林/他唑巴坦与丙磺舒合并应用可使哌拉西林和他唑巴坦的半衰期延长（哌拉西林的半衰期延长21%，他唑巴坦的半衰期延长71%）、肾脏清除率降低
瑞舒伐他汀	他汀类药物	不良反应增加	与其他他汀类药物一样，瑞舒伐他汀和夫西地酸合用的上市后经验中，已报告出现肌肉相关事件（包括横纹肌溶解）
氨苄西林	保泰松	药效提高，不良反应增加	丙磺舒、阿司匹林、吲哚美辛、保泰松、磺胺药可减少氨苄西林自肾脏排泄，因此与氨苄西林合用时使其血药浓度增高，排泄时间延长，毒性也可能增加
盐酸伊伐布雷定片	地尔硫卓	药效提高	中效CYP3A4抑制剂：在健康志愿者和患者中进行的相互作用研究显示，盐酸伊伐布雷定片与具有降低心率作用的药物地尔硫卓或者维拉帕米合并使用时，可导致伊伐布雷定的暴露量增加（AUC增加2至3倍），以及心率额外降低5次/分钟
达比加群	酮康唑	药效提高	预计与强效P-gp抑制剂（如：胺碘酮、维拉帕米、奎尼丁、酮康唑、决奈达隆和克拉霉素）的联合使用会导致达比加群血药浓度升高
复方肝浸膏	四环素类	药效降低	复方肝浸膏与四环素类药物同用可形成络合物
氟哌噻吨美利曲辛片	肾上腺素	药效降低	肾上腺素神经阻断剂：氟哌噻吨美利曲辛片可降低胍乙啶、倍他尼定、利舍平、可乐定、甲基多巴的抗高血压作用
阿莫西林	别嘌呤醇	药效提高	丙磺舒降低阿莫西林从肾小管中分泌，与阿莫西林合用时会升高阿莫西林的血药浓度，建议不与利尿酸药合用；别嘌呤醇(治痛风药)和阿莫西林合用会增加病人皮疹的发病率，尚未明确阿莫西林引发皮疹是由于因病人体内的别嘌呤醇还是因血尿酸升高引起的，尚未有阿莫西林与别嘌呤醇合用的资料；与其他广谱抗生素相似，阿莫西林可能降低避孕药的药效
辛伐他汀	环孢素	不良反应增加	辛伐他汀与免疫抑制剂如环孢素、红霉素、吉非罗齐、盐酸等合用可增加肌溶解和急性肾功能衰竭发生的危险
文拉法辛	印地那韦	药效降低	印地那韦：在9名健康志愿者的研究中，口服文拉法辛150mg/天达到稳态时，文拉法辛使单次口服800mg的印地那韦的AUC下降28%，使Cmax减低36%
克拉维酸钾	丙磺舒	药效提高	不推荐克拉维酸钾与丙磺舒合用，丙磺舒可降低肾小管对阿莫西林的分泌
酮洛芬	丙磺舒	药效提高，不良反应增加	酮洛芬肠溶片不应与丙磺舒同用，因后者可明显降低酮洛芬肠溶片肾脏清除率(降低66%)和蛋白结合率(降低28%)，导致血药浓度增高，而有引起中毒的危险
阿咖（阿司匹林、咖啡因）	碳酸氢钠	药效降低	抗酸药如碳酸氢钠等可增加阿咖自尿中的排泄，使血药浓度下降，不宜同用
吲达帕胺	降压药	药效提高	达帕胺与其他种类降压药同用时降压作用增强；
胰岛素	奎宁	药效提高	氯喹、奎尼丁、奎宁等可延缓胰岛素的降解，使血中胰岛素浓度升高从而加强其降血糖作用
格列齐特分散片	胰岛素	药效降低	β肾上腺素受体阻滞药可拮抗格列齐特分散片促胰岛素分泌的作用，故也可致高血糖
索他洛尔	如胺碘酮	不良反应增加	抗心律失常药Ia类抗心律失常药如丙吡胺、奎尼丁和普鲁卡因胺以及其他Ⅲ类药物如胺碘酮，有可能延长不应期，不应与索他洛尔合用
氯化钠	呋喃苯胺酸	药效降低，不良反应增加	氯化钠与碱性药液(如呋喃苯胺酸、甲氨蝶呤、氟尿嘧啶、吡咯他尼等注射液)或鬼臼乙叉苷注射液配伍会发生浑浊或结晶析出
布洛芬	肝素	药效提高，不良反应增加	布洛芬与肝素、双香豆素等抗凝药同时使用，可导致凝血酶原时间延长，增加出血倾向
复方曲尼司特	普萘洛尔	药效降低	同时应用β受体阻滞剂（如普萘洛尔）时，复方曲尼司特的作用可被显著降低
利福平	左旋甲状腺素	药效降低	利福平可增加左旋甲状腺素在肝脏中的降解、因此两者合用时左旋甲状腺素剂量应增加
酮替芬	催眠药	药效提高	与多种中枢神经抑制药（如镇静药、催眠药）或酒精、抗组胺药并用，可以增强酮替芬的镇静作用
小儿葡磷泛三钙片	含铝的抗酸药	不良反应增加	含铝的抗酸药与小儿葡磷泛三钙片同服用时，铝的吸收增多
苯海索	丙卡巴肼	药效提高，不良反应增加	苯海索与金刚烷胺、抗胆碱药、单胺氧化酶抑制药帕吉林及丙卡巴肼合用时，可加强抗胆碱作用，并可发生麻痹性肠梗阻
维生素A	维生素E	药效提高	与维生素E合用时，可促进维生素A吸收和利用
甲苯磺酸妥舒沙星	钙	药效降低	不宜与含钙、镁的制酸药或铁制剂同时服用，若两者同时服用会减少甲苯磺酸妥舒沙星分散片的吸收
胰岛素	抗凝血	药效降低，不良反应增加	抗凝血药、水杨酸盐、磺胺类药及抗肿瘤药甲氨喋呤等可与胰岛素竞争和血浆蛋白结合，从而使血液中游离胰岛素水平增高
多巴胺	酚妥拉明	药效降低	大剂量多巴胺与α受体阻滞药如酚苄明、酚妥拉明、妥拉唑林等同用，后者的扩血管效应可被多巴胺的外周血管收缩作用拮抗
氯化钠	头孢噻吩	不良反应增加	氯化钠与头孢噻吩合用可能增加肾毒性
黄体酮	酮康唑	药效提高	酮康唑是细胞色素P450酶的抑制剂，因此，酮康唑或其它细胞色素酶的抑制可能增加黄体酮的血药浓度
对乙酰氨基酚	颠茄	不良反应增加	应与巴比妥类（如苯巴比妥）或解痉药（如颠茄）的患者，长期应用对乙酰氨基酚可致肝损害
哌嗪	达卡巴嗪	药效降低，不良反应增加	哌嗪可诱导肝微粒体酶，增加抗肿瘤药达卡巴嗪(dacarbazine)、环磷酰胺的代谢，形成烷化代谢物，促使白细胞减低，因此需调整剂量
氧	抗凝剂	药效提高	氧与香豆素类抗凝剂（如苄丙酮香豆素）合用，可抑制其肝代谢
瑞舒伐他汀	氢氧化铝	药效降低	抗酸药：同时给予瑞舒伐他汀和一种含氢氧化铝镁的抗酸药混悬液，可使瑞舒伐他汀的血浆浓度降低约50%
己烯雌酚	抗凝药	药效降低	烯雌酚与抗凝药同用时，可降低后者抗凝效应
阿托伐他汀	利福平	药效降低	细胞色素P4503A4诱导剂：阿托伐他汀与细胞色素P4503A4诱导剂(如：依法韦仑、利福平、贯叶连翘)联合应用能使阿托伐他汀血浆浓度产生不同水平的降低
三维B	碱性溶液	药效降低	维生素B在碱性溶液中易分解如与碳酸氢钠枸橼酸钠配伍可引起三维B片中维生素B失效
肝素	镇痛药	药效提高，不良反应增加	（l）肝素与下列药物合用，可加重出血危险：①香豆素及其衍生物，可导致严重的因子Ⅸ缺乏而致出血；②阿司匹林及非甾体消炎镇痛药，包括甲芬那酸、水杨酸等均能抑制血小板功能，并能诱发胃肠道溃疡出血；③双嘧达莫、右旋糖酐等可能抑制血小板功能；④肾上腺皮质激素、促肾上腺皮质激素等易诱发胃肠道溃疡出血；⑤其他尚有利尿酸、组织纤溶酶原激活物（t-PA）、尿激酶、链激酶等
精氨酸布洛芬	抗高血压药	药效降低	精氨酸布洛芬与呋塞米(呋喃苯胺酸)同用时，后者的排钠和降压作用减弱；与抗高血压药同用时，也降低后者的降压效果
地诺孕素	雌二醇	药效降低	通过AUC（0-24）衡量的地诺孕素和雌二醇的系统性暴露量，分别下降了83%和44%
硝酸异山梨酯	双氢麦角胺	药效提高	同时服用硝酸异山梨酯，可以增加双氢麦角胺的升血压效果
辛伐他汀	细胞色素P4503A4	不良反应增加	当辛伐他汀与其他在治疗剂量下对细胞色素P4503A4有明显抑制作用的药物（如：环孢霉素、米贝地尔、伊曲康唑、酮康唑、红霉素、克拉霉素和奈法唑酮）或纤维酸类衍生物或烟酸合用时，导致横纹肌溶解的危险性增高
雷尼替丁	咪达唑仑	药效降低	雷尼替丁影响胃内pH值，从而可能导致药物的吸收增加（例如三唑仑，咪达唑仑，格列吡嗪）或吸收减少（例如酮康唑，阿扎那韦，地拉夫定，吉非替尼）
氨溴索	红霉素	药效提高	氨溴索与抗生素（阿莫西林、头孢呋新、红霉素、强力霉素）同时服用，可导致抗生素在肺组织浓度升高
拓扑替康	顺铂	药效提高	拓扑替康与顺铂、卡莫司汀或美法仑合用可加速杀伤仓鼠V79细胞和许多人体癌细胞
达比加群	奎尼丁	药效提高	预计与强效P-gp抑制剂（如：胺碘酮、维拉帕米、奎尼丁、酮康唑、决奈达隆和克拉霉素）的联合使用会导致达比加群血药浓度升高
唑吡坦	酮康唑	药效提高	合并使用酮康唑与单独使用唑吡坦相比，唑吡坦的总AUC提高1.83倍
氨溴索	红霉素	药效提高	氨溴索与抗生素（阿莫西林、头孢呋辛、红霉素、强力霉素）同时服用，可导致抗生素在肺组织浓度升高
米非司酮	卡马西平	药效降低	此外，利福平、地塞米松、S.John，麦芽汁和某些抗惊厥药（苯妥英、苯巴比妥、卡马西平）可能诱导米非司酮代谢（降低米非司酮血清水平）
克拉霉素	齐多夫定	药效降低	HIV感染的成年人同时口服克拉霉素和齐多夫定时，克拉霉素会干扰后者的吸收使其稳念血浓度下降，应错开服用时间
硝酸异山梨酯	西地那非	药效提高，不良反应增加	和西地那非合用会加强硝酸异山梨酯的降压作用（见禁忌），这将导致危及生命的心血管并发症，所以正在接受硝酸异山梨酯治疗的病人不可使用西地那非
加兰他敏	阿米替林	药效提高	阿尔茨海默病患者人群药代动力学分析显示，与CYP2D6酶抑制剂(阿米替林、氟西汀、氟伏沙明、帕罗西汀及奎尼丁)同服，加兰他敏的清除率减少了约25%－33%
呋喃妥因	苯磺唑酮	药效降低，不良反应增加	丙磺舒和苯磺唑酮均可抑制呋喃妥因的肾小管分泌，导致后者的血药浓度增高和(或)血清半衰期延长，而尿浓度则见降低，疗效亦减弱
异烟肼	阿芬太尼	药效提高，不良反应增加	与阿芬太尼(alfentanil)合用时，由于异烟肼为肝药酶抑制剂，可延长阿芬太尼的作用；与双硫仑(disulfiram)合用可增强其中枢神经系统作用，产生眩晕、动作不协调、易激惹、失眠等；与安氟醚合用可增加具有肾毒性的无机氟代谢物的形成
酮替芬	抗组胺药	药效提高	与多种中枢神经抑制药（如镇静药、催眠药）或酒精、抗组胺药并用，可以增强酮替芬的镇静作用
氯唑西林	丙磺舒	药效提高，不良反应增加	丙磺舒、阿司匹林、吲哚美辛、保泰松、磺胺药可减少氯唑西林在肾小管的排泄，使氯唑西林的血药浓度升高，血清半衰期延长，毒性也可能增加
氨氯地平	硝酸甘油	药效提高	13、舌下硝酸甘油和长效硝酸酯制剂：与氨氯地平合用可加强抗心绞痛效应
普罗布考	环孢素	药效降低	普罗布考与环孢素合用时，与单独服用环孢素相比，可明显降低后者的血药浓度
贝诺酯维B1	抗凝剂	药效提高	贝诺酯维B1与口服抗凝剂同服可延长凝血酶原时间
肌苷氯化钠注射液	氯氮卓	药效降低，不良反应增加	肌苷氯化钠注射液禁与下列注射液配伍：乳清酸、氯霉素、双嘧达莫、盐酸山梗菜碱、硫酸阿托品、氢溴酸东莨菪碱、盐酸氯丙嗪、盐酸异丙嗪、马来酸麦角新碱、盐酸普鲁卡因、硫喷妥钠、苯妥英钠、氯氮卓、盐酸去甲肾上腺素、盐酸丁卡因、利血平、硝普钠、降压嗪、呋噻米、利尿酸钠、促皮质素、维生素B12、盐酸苯海拉明、马来酸氯苯那敏、细胞色素C、盐酸万古霉素、盐酸四环素、二盐酸奎宁、盐酸阿糖胞苷、硫酸长春新碱以及所有菌苗和疫苗
利多卡因Ⅰ	磺胺嘧啶	不良反应增加	与西咪替丁以及β受体阻断剂如，普萘洛尔、美托洛尔、纳多洛尔合用，利多卡因经肝脏代谢受抑制，利多卡因血浓度增加，可发生心脏和神经系统不良反应，应调整利多卡因剂量，并应心电图监护及监测利多卡因血药浓度；(2)巴比妥类药物可促进利多卡因代谢，两药合用可引起心动过缓，窦性停搏；(3)与普鲁卡因胺合用，可产生一过性谵妄及幻觉，但不影响利多卡因Ⅰ血药浓度；(4)异丙基肾上腺素因增加肝血流量，可使利多卡因Ⅰ的总清除率升高；去甲肾上腺素因减少肝血流量，可使利多卡因Ⅰ总清除率下降；(5)与下列药品有配伍禁忌：苯巴比妥，硫喷妥钠，硝普钠，甘露醇，两性霉素B，氨苄西林，磺胺嘧啶
托烷司琼	苯巴比妥	药效降低	盐酸托烷司琼若与利福平或其他肝酶诱导药物（如苯巴比妥）同时使用，则可导致盐酸托烷司琼的血浆浓度降低，因此代谢正常者需增加剂量（代谢不良者不需增加）
琥珀酸亚铁颗粒	西咪替丁	药效降低	琥珀酸亚铁颗粒与西咪替丁、去铁胺、二巯丙醇、胰酶、胰脂肪酶等同用，可影响铁的吸收；与铁合用，可影响四环素、氟喹诺酮类、青霉胺及锌制剂的吸收
雷贝拉唑	地高辛	药效提高	正常受试者同时服用雷贝拉唑钠结果导致酮康唑水平下降33%，地高辛水平升高22%
呱西替柳干混悬剂	抗酸药	药效降低	抗酸药如碳酸氢钠等可加速呱西替柳干混悬剂自尿中的排泄，不宜同用
碳酸钙片	苯妥英钠	药效降低	碳酸钙片与苯妥英钠及四环素类同用，二者吸收减少
特比萘芬	利福平	药效降低	联合服用利福平可使特比萘芬的清除率增加100％
布地奈德	皮质激素	药效提高	作为皮质激素代谢的主要代谢酶-细胞色素P450CYP3A的强抑制剂，酮康唑可增加布地奈德的全身暴露量
氢溴酸二氢加兰他敏注射液	地高辛	不良反应增加	有报道氢溴酸二氢加兰他敏注射液与地高辛合用时出现房室传导阻滞
奥硝唑	华法林	药效提高	奥硝唑能抑制抗凝药华法林的代谢，使其半衰期延长，增强抗凝药的药效
己酮可可碱	降糖药	药效提高	己酮可可碱可增强降压药、降糖药及抗凝药的药理作用
维生素D滴剂	钙	不良反应增加	大剂量钙剂或利尿药（一些降压药）与维生素D滴剂同用，可能发生高钙血症
复方对乙酰氨基酚	颠茄	不良反应增加	应用巴比妥类（如苯比妥）或解痉药（如颠茄）的患者，长期使用复方对乙酰氨基酚时可至肝脏损害，故不应同服
奎宁	奎尼丁	药效提高，不良反应增加	酸药及含铝制剂能延缓或减少奎宁的吸收；②抗凝药与奎宁合用后，抗凝作用可增强；③肌肉松弛药如琥珀胆碱、筒箭毒碱等与奎宁合同，可能会引起呼吸抑制；④奎尼丁与奎宁合用，金鸡纳反应可增加；⑤尿液碱化剂如碳酸氢钠等，可增加肾小管对奎宁的重吸收，导致奎宁血药浓度与毒性的增加；⑥与维生素K合用可增加奎宁的吸收；⑦与布克利嗪、赛克利嗪、美克利嗪、吩噻嗪类、噻吨类、曲美苄胺（trimethofenzamide）、氨基苷类抗生素合用可导致耳鸣、眩晕；⑧与硝苯地平（硝苯啶）合用，游离的奎宁浓度增加
比索洛尔	奎尼丁	药效提高	I类抗心律失常药物（如丙吡胺、奎尼丁）：可能增加比索洛尔对房室传导和心脏收缩力的抑制作用
利多卡因Ⅱ	西咪替丁	药效提高，不良反应增加	与西咪替丁以及β受体阻断剂如，普萘洛尔、美托洛尔、纳多洛尔合用，利多卡因经肝脏代谢受抑制，利多卡因血浓度增加，可发生心脏和神经系统不良反应，应调整利多卡因剂量，并应心电图监护及监测利多卡因血药浓度；(2)巴比妥类药物可促进利多卡因代谢，两药合用可引起心动过缓，窦性停搏；(3)与普鲁卡因胺合用，可产生一过性谵妄及幻觉，但不影响利多卡因Ⅱ血药浓度；(4)异丙基肾上腺素因增加肝血流量，可使利多卡因Ⅱ的总清除率升高；去甲肾上腺素因减少肝血流量，可使利多卡因Ⅱ总清除率下降；(5)与下列药品有配伍禁忌：苯巴比妥，硫喷妥钠，硝普钠，甘露醇，两性霉素B，氨苄西林，磺胺嘧啶
咪达普利	吲哚美辛	药效降低	与非甾体抗炎药物(吲哚美辛)合用则使咪达普利降压作用减弱
洛伐他汀颗粒	达那唑	不良反应增加	洛伐他汀颗粒与免疫抑制剂如环孢素、阿奇霉素、克拉霉素、红霉素、达那唑、伊曲康唑、吉非罗齐、烟酸等合用可增加肌溶解和急性肾功能衰竭发生的危险
布洛芬	甲氨喋呤	不良反应增加	口服降糖药、甲氨喋呤、苯妥英、毛地黄、锂剂及饮洒等可降低布洛芬耐受量
抑肽酶	卡托普利	药效降低	抑肽酶可抑制血管紧张素转换酶抑制剂（如卡托普利）的降压作用（曾有报道，但尚无结论性意见）
青霉素	丙磺舒	药效提高	丙磺舒可减少苯唑青霉素的肾小管分泌，延长青霉素的血清半衰期
拉呋替丁颗粒	茶碱	药效提高，不良反应增加	其它H2受体阻滞药能与细胞色素P450结合，从而降低肝微粒体药物代谢酶的活性，因此拉呋替丁颗粒与华法林、苯妥英钠、茶碱、苯巴比妥、安定或普奈洛尔和西米替丁合用时应注意
阿托伐他汀钙片	口服避孕药	药效提高	当服用阿托伐他汀钙片的妇女选择口服避孕药时应考虑到AUC的增加
阿利吉仑	酮康唑	药效提高	酮康唑：酮康唑（200mg，每天2次）与阿利吉仑（300mg）联合使用，会使阿利吉仑的血药水平（AUC和Cmax）升高1.8倍
酮洛芬	肝素	药效提高，不良反应增加	酮洛芬与肝素、双香豆素等抗凝药同时使用，可导致凝血酶原时间延长，增加出血倾向
妥拉唑啉	去甲肾上腺素	药效降低，不良反应增加	应用妥拉唑啉后，再应用甲氧明或去甲肾上腺素将阻滞后者的升压作用，可能出现严重的低血压
米格列醇	普萘洛尔	药效降低	其它在健康受试者中进行的试验证实了米格列醇可使雷尼替丁和普萘洛尔的生物利用度分别下降60％和40％
甲氨蝶呤	NSAIDs	不良反应增加	有报道大剂量甲氨蝶呤同时使用NSAIDs，能提高并延长甲氨蝶呤血清浓度，结果导致患者因为严重的血液学和胃肠道毒性而死亡
茶碱Ⅱ	依诺沙星	药效提高，不良反应增加	与克林霉素、林可霉素及某些大环内酯类（红霉素、罗红霉素、克拉霉素）、喹诺酮类抗菌药（依诺沙星、环丙沙星）合用时，可降低茶碱Ⅱ在肝脏的代谢，血药浓度升高，甚至出现毒性，应在给药前后调整茶碱Ⅱ的用量
克拉霉素	齐多夫定	药效降低	HIV感染的成年人同时口服克拉霉素与齐多夫定会引起齐多夫定稳态血浓下降，这主要是由于克拉霉素会干扰齐多夫定的吸收，故错开服用时间可避免这种影响
利福喷丁	酮康唑	药效降低	与咪康唑或酮康唑合用，可使后两者血药浓度减低，故利福喷丁不宜与咪唑类合用
茚地那韦	地塞米松	药效降低	对CYP3A4诱导作用弱于利福平的其他药物，如苯巴比妥、苯妥英、卡马西平和地塞米松，与茚地那韦合用时应谨慎，因为它们也可能降低茚地那韦的血浆浓度
注射用头孢地嗪钠	万古霉素	不良反应增加	注射用头孢地嗪钠可加强具有潜在肾毒性药物的毒性作用，如与氨基糖甙类、两性霉素B、环孢素、顺铂、万古霉素、多粘菌素B或粘菌素同时或先后使用时应密切监测肾功能
布洛芬颗粒	抗凝药	药效提高，不良反应增加	布洛芬颗粒与肝素、双香豆素等抗凝药同用时，可导致凝血酶原时间延长，增加出血倾向
拉贝洛尔	甲氧氯普胺	药效提高	甲氧氯普胺（胃复安）可增强拉贝洛尔的降压作用
美西律	奎尼丁	药效提高	美西律与奎尼丁、普奈洛尔或胺碘酮合用治疗效果更好
托拉塞米	考来烯胺	药效降低	合并消胆胺（考来烯胺）治疗时，可减少托拉塞米的生物利用度并因而减弱其疗效；
塞利洛尔	氯噻酮	药效降低	食物能降低塞利洛尔的生物利用度，与氯噻酮及氢氯噻嗪合用时亦可能降低塞利洛尔的生物利用度
多沙普仑	异氟烷	不良反应增加	多沙普仑能促进儿茶酚胺的释放增多，在全麻药如氟烷、异氟烷等停用10-20分钟后，才能使用
利多卡因Ⅰ	美托洛尔	不良反应增加	与西咪替丁以及β受体阻断剂如，普萘洛尔、美托洛尔、纳多洛尔合用，利多卡因经肝脏代谢受抑制，利多卡因血浓度增加，可发生心脏和神经系统不良反应，应调整利多卡因剂量，并应心电图监护及监测利多卡因血药浓度；(2)巴比妥类药物可促进利多卡因代谢，两药合用可引起心动过缓，窦性停搏；(3)与普鲁卡因胺合用，可产生一过性谵妄及幻觉，但不影响利多卡因Ⅰ血药浓度；(4)异丙基肾上腺素因增加肝血流量，可使利多卡因Ⅰ的总清除率升高；去甲肾上腺素因减少肝血流量，可使利多卡因Ⅰ总清除率下降；(5)与下列药品有配伍禁忌：苯巴比妥，硫喷妥钠，硝普钠，甘露醇，两性霉素B，氨苄西林，磺胺嘧啶
非索非那定	酮康唑	药效提高	盐酸非索非那定虽然表现出较小的肝脏代谢率(5%)，但当与红霉素、酮康唑作用时会导致盐酸非索非那定的血药浓度升高
福莫特罗	β-受体阻滞剂	药效降低	药效学相互作用：哮喘患者应避免使用β-受体阻滞剂（包括滴眼液），如果必须使用β-受体阻滞剂，福莫特罗的效应可能被减弱或抵消
双氯芬酸Ⅳ	甲氨蝶呤	药效提高，不良反应增加	双氯芬酸Ⅳ可降低甲氨蝶呤的排泄，增高其血浓度，甚至可达中毒水平，故双氯芬酸Ⅳ不应与中或大剂量甲氨喋呤同用
复方葡萄糖酸钙口服溶液	苯妥英钠	药效降低	复方葡萄糖酸钙口服溶液与苯妥英钠及四环素类同用，二者吸收减少
伪麻那敏	氟哌啶醇	药效提高	伪麻那敏可增强金刚烷胺、抗胆碱药，氟哌啶醇、吩噻嗪类及拟交感神经药的作用；
雷贝拉唑	抗酸剂	药效降低	雷贝拉唑钠与抗酸剂同时服用以及在服用抗酸剂1小时后再服用时，雷贝拉唑的平均血浆中浓度曲线下面积分别下降8%和6%
利福平	环磷酰胺	药效降低，不良反应增加	利福平可诱导肝微粒体酶，增加抗肿瘤药达卡巴嗪(dacarbazine)、环磷酰胺的代谢，形成烷化代谢物，促使白细胞减低，因此需调整剂量
凝结芽孢杆菌活菌	复方新诺明	药效降低	凝结芽孢杆菌对氨苄青霉素、新霉素、头孢唑啉、头孢呋辛、头孢噻肟、氯霉素、呋喃唑酮（痢特灵）、复方新诺明和氟哌酸等敏感，故凝结芽孢杆菌活菌不能与此类药物同时服用
牡蛎碳酸钙咀嚼片	含铝的抗酸药	不良反应增加	含铝的抗酸药与牡蛎碳酸钙咀嚼片同服时，铝的吸收增多
利拉鲁肽	地高辛	药效降低	单次给予地高辛1mg同时合用利拉鲁肽可使地高辛的AUC降低16%,Cmax降低31%tmax从1小时延长至1.5小时
环孢素软胶囊	胺碘酮	药效提高	提高环孢素软胶囊血浆或全血浓度的药品有：酮康唑、氟康唑、伊曲康唑、红霉素、交沙霉素、克拉霉素等大环内酯类抗生素，强力霉素、口服避孕药、普罗帕酮以及地尔硫卓、尼卡地平、维拉帕米等钙拮抗剂，氟伏沙明、乙酰唑胺、甲氧氯普胺、达那唑、甲泼尼龙（高剂量）、别嘌醇、胺碘酮、胆酸及其衍生物、蛋白酶抑制剂
链霉素	头孢噻吩	不良反应增加	链霉素与头孢噻吩局部或全身合用可能增加肾毒性
酮康唑	异烟肼	药效降低	与异烟肼同用时可降低酮康唑的血药浓度，故应谨慎合用
复方磺胺甲噁唑颗粒	利福平	药效降低	利福平与复方磺胺甲噁唑颗粒合用时，可明显使复方磺胺甲噁唑颗粒中的TMP清除增加和血清半衰期缩短
普伐他汀	吉非贝齐	药效提高，不良反应增加	吉非贝齐：临床试验发现，普伐他汀与吉非贝齐合用，CPK水平升高和骨骼肌肉症状而停药的发生率，与安慰剂对照组、单用吉非贝齐组、单用普伐他汀组相比，有升高的趋势，普伐他汀的尿排泄量及其蛋白结合均减少，同时普伐他汀的代谢产物SQ31，906的AUC，Cmax值明显增加，Tmax延长
头孢拉定	钙溶液	药效降低，不良反应增加	头孢拉定中含有碳酸钠，因此与含钙溶液如复方氯化钠注射液有配伍禁忌
瑞舒伐他汀	维生素K拮抗剂	不良反应增加	维生素K拮抗剂：同其它HMG－CoA还原酶抑制剂一样，对同时使用维生素K拮抗剂（如：华法林）的患者，开始使用瑞舒伐他汀或逐渐增加瑞舒伐他汀剂量可能导致INR升高
替米沙坦	地高辛	药效提高	替米沙坦可升高地高辛平均波谷谷血药浓度0%（个别病例升高39%），因此须监测地高辛血浆浓度
文拉法辛	曲马多	不良反应增加	类似其它5-羟色胺能药物，使用文拉法辛治疗时，可能发生5-羟色胺综合征（一种有潜在生命威胁的情况），尤其是在与以下药物合并使用时：其它作用于5-羟色胺递质系统的药物（包括曲坦、SSRIs、其它SNRIs、锂盐、西布曲明、曲马多或圣约翰草[金丝桃属植物提取物]），损害5-羟色胺代谢的药物（如MAOIs，包括利奈唑胺[一种抗生素，是可逆性、非选择性的MAOI]和亚甲蓝）或5-羟色胺前体（如：色氨酸补充剂）（见[禁忌]和[注意事项]）
非诺贝特	甲苯磺丁脲	药效提高	非诺贝特与其它髙蛋白结合率的药物合用时，可使它们的游离型增加，药效增强，如甲苯磺丁脲及其它磺脲类降糖药、苯妥英、呋塞米等，在降血脂治疗期间服用上述药物，则应调整降糖药及其它药的剂量
非洛地平	卡马西平	药效降低	与卡马西平、苯妥英和苯巴比妥合用时非洛地平的AUC减小93%、Cmax减小82%
哌嗪	咪康唑	药效降低	利福平与咪康唑或酮康唑合用，可使后两者血药浓度减低，故哌嗪不宜与咪唑类合用
氨溴索	阿莫西林	药效提高	氨溴索与抗生素（阿莫西林、头孢呋新、红霉素、强力霉素）同时服用，可导致抗生素在肺组织浓度升高
利托那韦	卡马西平	药效降低	苯巴比妥、卡马西平、苯妥因和利福平能增加CYP3A4的活性，很可能与利托那韦发生相互作用，增加利托那韦的清除，降低利托那韦的活性
头孢哌酮	多西环素	药效降低，不良反应增加	头孢哌酮与下列药物注射剂有配伍禁忌：阿米卡星、庆大霉素、卡那霉素B、多西环素、甲氯芬酯、阿马林(缓脉灵)、苯海拉明、门冬酸钾镁、盐酸羟嗪(安太乐)、普鲁卡因胺、氨茶碱、丙氯拉嗪、细胞色素C、喷他佐辛(镇痛新)、抑肽酶等
洛伐他汀颗粒	阿奇霉素	不良反应增加	洛伐他汀颗粒与免疫抑制剂如环孢素、阿奇霉素、克拉霉素、红霉素、达那唑、伊曲康唑、吉非罗齐、烟酸等合用可增加肌溶解和急性肾功能衰竭发生的危险
维生素D3	扑米酮	药效降低，不良反应增加	巴比妥、苯妥英钠、抗惊厥药、扑米酮等可降低维生素D3的效应，因此长期服用抗惊厥药时应补给维生素D3，以防止骨软化症
地巴唑	抗真菌药	药效提高，不良反应增加	地巴唑与抗真菌药酮康唑、伊曲康唑合用，可提高地巴唑疗效并增加其毒性
罗哌卡因	依诺沙星	药效提高	因此，与耐乐品同时给予CYP1A2的强抑制剂，如氟伏沙明和依诺沙星，可导致使血浆中罗哌卡因浓度升高的代谢相互作用
氯吡格雷	NSAIDs	不良反应增加	非甾体抗炎剂（NSAIDs）：在健康志愿者进行的临床试验中，氯吡格雷与萘普生合用使胃肠道隐性出血增加
吉米沙星	奥美拉唑	药效提高	奥美拉唑：单剂量给予320mg吉米沙星与奥美拉唑40mg每日一次连续4天共同服用，吉米沙星的AUC（0-inf）与Cmax的均值略有升高，分别升高10%与11%
卡马西平	苯妥英	药效提高	据报道，在卡马西平的作用下，血浆苯妥英水平既可升高也可降低，不过很少有病例报道可导致美芬妥英血浆水平增高
三硅酸镁	地西泮	药效降低	三硅酸镁与地西泮类药物（安定）合用时，后者吸收率降低
氨苄西林	氯唑西林	药效提高	丙磺舒可减少氯唑西林的肾小管分泌、延长氨苄西林的血清半衰期
水杨酸	口服降糖药	药效提高，不良反应增加	水杨酸可加强口服降糖药及甲氨蝶呤的作用，不应同用
利福平	去甲替林	药效降低	据报道利福平可加快下列药物的代谢：抗惊厥药(如苯妥英)，抗心律失常药(如双异丙吡按、美西律、奎尼丁、妥卡尼)，口服抗凝血药，抗真菌药(如氟康唑、伊曲康唑、酮康唑等)，巴比土酸盐，β-阻滞剂，钙离子阻滞剂(如硫氮卓酮、硝苯吡啶、维拉帕米等)，氯霉素、克拉霉素、皮质类固醇、环孢霉素、洋地黄甙类、氯贝特、激素类避孕药，氨苯砜、安定、强力霉素、氟喹诺酮类(如环丙沙星)、氟哌啶醇、口服降糖药(磺酰脲)，左旋甲状腺素、美沙酮、麻醉性镇痛药，去甲替林、孕激素、奎林、茶碱、他克莫司、三环类抗抑郁药(阿米替林、去甲替林)和叠氮胸苷
巴氨西林	华法林	药效提高	巴氨西林可加强华法林的作用
盐酸氨溴索口腔崩解片	阿莫西林	药效提高	盐酸氨溴索口腔崩解片与抗生素（阿莫西林、头孢呋新、红霉素、强力霉素）同时服用，可导致抗生素在肺组织浓度升高
萘普生	丙磺舒	药效提高，不良反应增加	萘普生钠与丙磺舒同用，血药浓度升高，T1/2延长，可增加疗效，但不良反应也相应增加
右旋糖酐铁口服溶液	磷酸盐	药效降低	右旋糖酐铁口服溶液与磷酸盐类、四环素类及鞣酸等同服，可防碍铁的吸收
氢氯噻嗪	消胆胺	药效降低	消胆胺和降脂树脂：阴离子交换树脂可影响氢氯噻嗪吸收；服用单剂量消胆胺和降脂树脂可使胃肠道吸收分别下降85％和43％
阿莫西林克拉维酸	别嘌呤醇	不良反应增加	虽然尚无阿莫西林克拉维酸与别嘌呤醇合用的资料，但阿莫西林与别嘌呤醇合用可能增加皮肤过敏反应
丙戊酸镁片	苯妥英钠	药效提高	丙戊酸镁片能抑制苯妥英钠、苯巴比妥、扑米酮、乙琥胺的代谢，使血药浓度升高
阿莫西林克拉维酸	吲哚美辛	药效提高，不良反应增加	司匹林、吲哚美辛、保泰松、磺胺药可减少阿莫西林克拉维酸在肾小管的排泄，因而使阿莫西林克拉维酸的血药浓度升高，血消除半衰期（t1/2）延长，毒性也可能增加
硝苯地平	钙离子通道阻滞剂	药效降低	卡马西平:目前尚未进行硝苯地平与卡马西平是否有潜在相互作用的研究，但是因为卡马西平可诱导酶的活性，从而导致与硝苯地平结构相似的钙离子通道阻滞剂尼莫地平的血药浓度降低，因此不能排除二者合用可降低硝苯地平的血药浓度，从而降低疗效
可待因	巴比妥类	不良反应增加	长期饮酒或正在应用其它肝酶诱导剂时，尤其是巴比妥类或其它抗痉挛药的患者，连续使用可待因，有发生肝脏毒性的危险
复方单硝酸异山梨酯	西地那非	不良反应增加	复方单硝酸异山梨酯不适合与西地那非合用，因为会导致血压大幅度突降，从而出现头晕、晕厥的症状
金刚乙胺	阿司匹林	药效降低	阿司匹林：12位健康志愿者服金刚乙胺(0.1g，每日二次)，持续13天，在第11天，开始服用阿司匹林（0.65g,每日四次），持续8天，在第11天和13天评价金刚乙胺的药物动力学，发现和阿司匹林一同服用后，金刚乙胺的血浆峰值浓度和AUC值降低了约10%
艾普拉唑	氯米帕明	药效提高	国外研究结果显示，24例健康受试者口服艾普拉唑40mg/次，每天1次，用药5天，使CYP3A4酶的特异性底物咪达唑仑的血浆浓度升高31～41%，提示艾普拉唑属于CYP3A4酶的弱抑制剂，推测其对经CYP2C19酶代谢的药物（如地西泮、西酞普兰、丙米嗪、苯妥英钠、氯米帕明等）的代谢影响不大
罗红霉素Ⅱ	西沙必利	不良反应增加	西沙必利、匹莫齐特：两者均为肝细胞CYP3A同功酶代谢药物，可导致QT间期延长，不推荐罗红霉素Ⅱ与二者合用
硝酸异山梨酯	西地那非	药效提高	同时服用一氧化二氮供体，如硝酸异山梨酯中的活性成分和西地那非（Sildenafil）可明显增强硝酸异山梨酯的降压作用
卡马西平	左旋甲状腺素	药效降低	与含雌激素的避孕药、环孢素、洋地黄类（可能地高辛除外）、雌激素、左旋甲状腺素或奎尼丁合用时，由于卡马西平对肝代谢酶的正诱导，这些药的效应都会降低，用量应作调整，改用仅含孕激素（黄体酮）的口服避孕药
甲氨蝶呤	阿糖胞苷	药效降低，不良反应增加	有报道甲氨蝶呤与阿糖胞苷、氟尿嘧啶及强的松龙存在配伍禁忌
愈创木酚磺酸钾	肾上腺素	药效提高	溴苯胺、胍乙啶等降压药与愈创木酚磺酸钾同用时，前者的降压，效应可能增强，肾上腺素与愈创木酚磺酸钾同用时，肾上腺素的a作用被阻断，而使β作用占优势
酮洛芬	利尿剂	药效降低，不良反应增加	病人服用利尿剂同时服用酮洛芬,其风险大大增加,原因之二是酮洛芬抑制的前列腺素合成导致降低了肾脏血流灌注速度
奥硝唑	巴比妥类	药效降低	巴比妥类药物、雷尼替丁、西米替丁可加快奥硝唑的消除，当使用奥硝唑时应避免合用
甲羟孕酮	利福平	药效降低	和所有的孕激素类药物相同，甲羟孕酮联合巴比妥、苯妥英、扑米酮、卡马西平、利福平和灰黄霉素等酶诱导剂治疗会增加肝脏的分解代谢
维生素C	碳酸氢钠	药效降低	抗酸药如碳酸氢钠等可增加维生素C自尿中的排泄，使血药浓度下降，不宜同用
氯化钠	克拉霉素	药效提高，不良反应增加	与克林霉素、林可霉素及某些大环内酯类(红霉素、罗红霉素、克拉霉素)、喹诺酮类抗菌药(伊诺沙星、环丙沙星)合用时，可降低氯化钠在肝脏的清除率，使血药浓度升高，甚至出现毒性反应，应在给药时调整氯化钠的用量
多西环素	卡马西平	药效降低	巴比妥类、苯妥英或卡马西平与多西环素同用时，上述药物可由于诱导微粒体酶的活性致多西环素血药浓度降低，因此须调整多西环素的剂量
非索非那定	酮康唑	药效提高	体内动物研究也表明其不仅能促进吸收，酮康唑同时能减少盐酸非索非那定的胃肠道分泌，而红霉素尚可能降低其胆道分泌
比索洛尔	抗心律失常药物	药效提高	I类抗心律失常药物（如丙吡胺、奎尼丁）：可能增加比索洛尔对房室传导和心脏收缩力的抑制作用
利福平	抗凝药	药效降低	肾上腺皮质激素（糖皮质激素、盐皮质激素）、抗凝药、香豆素或茚满二酮衍生物、口服降血糖药、促皮质激素、氨苯砜、洋地黄苷类、丙吡胺、奎尼丁等与利福平合用时，由于后者对肝微粒体酶活性的刺激作用，可使上述药物的药效减低，因此除地高辛和氨苯砜外，在用利福平前和疗程中上述药物需调整剂量
环孢素软胶囊	异烟肼	药效降低	降低环孢素软胶囊血浆或全血浓度的有：巴比妥类药物、异烟肼、安乃近、卡马西平、苯妥英、Metamizole、利福平、萘夫西林、西咪替丁、磺胺二甲嘧啶注射剂、甲氧苄啶注射剂、曲格列酮、普罗布考、奥曲肽、贯叶连翘含有制剂、噻氯匹定
诺氟沙星	茶碱类	药效提高，不良反应增加	诺氟沙星与茶碱类合用时可能由于与细胞色素P450结合部位的竞争性抑制，导致茶碱类的肝清除明显减少，血消除半衰期（t1/2?）延长，血药浓度升高，出现茶碱中毒症状，如恶心、呕吐、震颤、不安、激动、抽搐、心悸等，故合用时应测定茶碱类血药浓度和调整剂量
双氯芬酸Ⅳ	甲氨喋呤	药效提高，不良反应增加	双氯芬酸Ⅳ可降低甲氨蝶呤的排泄，增高其血浓度，甚至可达中毒水平，故双氯芬酸Ⅳ不应与中或大剂量甲氨喋呤同用
哌拉西林	丙磺舒	药效提高	如同其他青霉素类药物，丙磺舒与哌拉西林／他唑巴坦联合应用，可降低哌拉西林与他唑巴坦两者的肾清除率而半衰期延长，但两种药物的血浆高峰浓度不受影响，没有发现哌拉西林／他唑巴坦与万古霉素之间的相互作用
头孢噻肟	美洛西林	药效提高	与阿洛西林或美洛西林等合用，可使头孢噻肟的总清除率降低，如两者合用需适当降低剂量
巴氯芬	吗啡	不良反应增加	此外有报道，在联合使用吗啡和鞘内注射巴氯芬时，会出现低血压
罗哌卡因	氟伏沙明	药效提高	在健康志愿者中，当与氟伏沙明，一种强效的CYP1A2竞争性抑制剂同时使用时，罗哌卡因的清除率下降达77%
哌拉西林	他唑巴坦	药效提高	如同其他青霉素类药物，丙磺舒与哌拉西林／他唑巴坦联合应用，可降低哌拉西林与他唑巴坦两者的肾清除率而半衰期延长，但两种药物的血浆高峰浓度不受影响，没有发现哌拉西林／他唑巴坦与万古霉素之间的相互作用
盐酸苯海拉明软胶囊	磺胺醋酰钠	药效降低	盐酸苯海拉明软胶囊可短暂影响巴比妥类药和磺胺醋酰钠等的吸收
比索洛尔	胍乙啶	药效提高，不良反应增加	比索洛尔与利血平﹑胍乙啶合用时，可增加比索洛尔的β受体阻滞作用，导致交感活性过度减低，应密切监测
对乙酰氨基酚口服溶液	氯霉素	不良反应增加	对乙酰氨基酚口服溶液与氯霉素同服时可增强后者的毒性
氯喹	环孢素	药效提高	已有环孢素和羟氯喹合用时血浆环孢素水平升高的报告
左旋多巴	多巴胺受体激动剂	药效提高	左旋多巴可与其他抗帕金森病药物（如抗胆碱能药物、金刚烷胺、溴隐亭和多巴胺受体激动剂等）联合使用，尽管治疗作用和不良反应可能同时增加
加压素	丙泊酚	不良反应增加	加压素同时应用降低心率的药物如丙泊酚、舒芬太尼时可导致严重心动过缓
头孢克洛干糖浆	氨基糖苷类抗生素	不良反应增加	呋塞米、依他尼酸、布美他尼等强利尿药，卡氮芥、链佐星等抗肿瘤药及氨基糖苷类抗生素等肾毒性药物与头孢克洛干糖浆合用有增加肾毒性的可能
鱼肝油乳	硫糖铝	药效降低	考来烯胺、矿物油、新霉素、硫糖铝能干扰鱼肝油乳中维生素A的吸收
酮洛芬	抗凝药	药效提高，不良反应增加	酮洛芬与肝素、双香豆素等抗凝药同时使用，可导致凝血酶原时间延长，增加出血倾向
曲唑酮	地高辛	药效提高	服用美抒玉（盐酸曲唑酮）的患者，如果同时使用地高辛或苯妥因，可使地高辛或苯妥因的血浆水平升高
加兰他敏	红霉素	药效降低	与红霉素合用，可减低加兰他敏的疗效
利多卡因	甘露醇	药效提高，不良反应增加	与西咪替丁以及β受体阻断剂如，普萘洛尔、美托洛尔、纳多洛尔合用，利多卡因经肝脏代谢受抑制，利多卡因血浓度增加，可发生心脏和神经系统不良反应，应调整利多卡因剂量，并应心电图监护及监测利多卡因血药浓度；(2)巴比妥类药物可促进利多卡因代谢，两药合用可引起心动过缓，窦性停搏；(3)与普鲁卡因胺合用，可产生一过性谵妄及幻觉，但不影响利多卡因血药浓度；(4)异丙基肾上腺素因增加肝血流量，可使利多卡因的总清除率升高；去甲肾上腺素因减少肝血流量，可使利多卡因总清除率下降；(5)与下列药品有配伍禁忌：苯巴比妥，硫喷妥钠，硝普钠，甘露醇，两性霉素B，氨苄西林，磺胺嘧啶
氨咖黄敏胶囊	解热镇痛药	不良反应增加	长期服用氨咖黄敏胶囊或与其它解热镇痛药同服有增加肾毒性之危险
甲硝唑氯化钠	苯妥英钠	药效降低	同时应用苯妥英钠、苯巴比妥等诱导肝微粒体酶的药物，可加强甲硝唑氯化钠代谢，使血药浓度下降，而苯妥英钠排泄减慢
磺胺多辛乙胺嘧啶	磺吡酮	药效提高，不良反应增加	磺吡酮与磺胺多辛乙胺嘧啶合用时可减少磺胺多辛乙胺嘧啶自肾小管的分泌，导致血药浓度升高而持久或产生毒性，因此在应用磺吡酮期间或应用其治疗后可能需要调整磺胺多辛乙胺嘧啶的剂量
注射用头孢地嗪钠	两性霉素B	不良反应增加	注射用头孢地嗪钠可加强具有潜在肾毒性药物的毒性作用，如与氨基糖甙类、两性霉素B、环孢素、顺铂、万古霉素、多粘菌素B或粘菌素同时或先后使用时应密切监测肾功能
复方对乙酰氨基酚	甲氨蝶呤	药效提高，不良反应增加	复方对乙酰氨基酚可加强口服降糖药及甲氨蝶呤的作用，不应同用
加替沙星	地丹诺辛	药效降低	硫酸亚铁，含铝或镁制酸剂和去羟基苷（地丹诺辛、惠妥兹）与加替沙星合用，加替沙星的生物利用度降低
托拉塞米	妥布霉素	不良反应增加	可加强氨基糖甙类抗生素（如卡那霉素、庆大霉素、妥布霉素）、抑制细胞增殖的铂衍生物和头孢菌素的耳毒性和肾脏毒性效应，特别是大剂量托拉塞米治疗时；
氯雷伪麻Ⅱ	对乙酰氨基酚	药效提高，不良反应增加	与氯霉素合用，氯雷伪麻Ⅱ所含对乙酰氨基酚可延长氯霉素的半衰期，增强其毒性；
维拉帕米	苯妥英	药效降低	诱导细胞色素P450同功酶3A4的药物如苯妥英，利福平，苯巴比妥和卡马西平：降低维拉帕米在血浆中的浓度，减弱其作用
地奈德	伊曲康唑	药效提高，不良反应增加	布地奈德的代谢转化可被由CYP3A4代谢的物质（例如伊曲康唑、酮康唑、利托那韦、奈非那韦、环孢素、炔雌醇和醋竹桃霉素）所抑制
多巴胺	酚苄明	药效降低	大剂量多巴胺与α受体阻滞药如酚苄明、酚妥拉明、妥拉唑林等同用，后者的扩血管效应可被多巴胺的外周血管收缩作用拮抗
他克莫司	尼伐地平	药效提高，不良反应增加	已知会抑制细胞色素P4503A4酶系统的药物：根据体外试验，下列药物可以视为他克莫司代谢的潜在性抑制剂：溴麦亭、可的松、氨苯砜、麦角胺、乙炔雌二醇、甲地孕酮、依他康唑、交沙霉素、利多卡因、甲妥因、咪康唑、尼卡地平、尼鲁地平、尼伐地平、炔诺酮、奎尼丁、他莫昔芬、三醋酸竹桃霉素、维拉帕米
肌苷氯化钠注射液	盐酸阿糖胞苷	药效降低，不良反应增加	肌苷氯化钠注射液禁与下列注射液配伍：乳清酸、氯霉素、双嘧达莫、盐酸山梗菜碱、硫酸阿托品、氢溴酸东莨菪碱、盐酸氯丙嗪、盐酸异丙嗪、马来酸麦角新碱、盐酸普鲁卡因、硫喷妥钠、苯妥英钠、氯氮卓、盐酸去甲肾上腺素、盐酸丁卡因、利血平、硝普钠、降压嗪、呋噻米、利尿酸钠、促皮质素、维生素B12、盐酸苯海拉明、马来酸氯苯那敏、细胞色素C、盐酸万古霉素、盐酸四环素、二盐酸奎宁、盐酸阿糖胞苷、硫酸长春新碱以及所有菌苗和疫苗
克林霉素磷酸酯氯化钠注射液	钙	不良反应增加	克林霉素磷酸酯氯化钠注射液可增强吸入性麻醉药的神经肌肉阻断现象，导致骨骼肌软弱和呼吸抑制或麻痹(呼吸暂停)，在手术中或术后同用时应注意，以抗胆碱酯酶药物或钙盐治疗可望有效
阿夫唑嗪	酮康唑	药效提高	强效CYP3A4抑制剂：多次口服酮康唑400mg，使单次口服阿夫唑嗪10mg后的Cmax、AUClast值分别增加2.3倍、3.2倍
利福平Ⅱ	地西泮	药效降低	利福平Ⅱ与地西泮（安定）合用可增加后者的消除，使其血药浓度减低，故需调整剂量
萘夫西林	去甲肾上腺素	药效降低，不良反应增加	萘夫西林与氨基糖苷类、去甲肾上腺素、间羟胺、苯巴比妥、维生素B族、维生素C等药物存在配伍禁忌，不宜同瓶滴注
茶愈	环丙沙星	药效提高，不良反应增加	茶愈与环丙沙星、托磺沙星及依诺沙星合用，茶碱血药浓度增加，可出现毒性，尤不宜与依诺沙星合用
奥硝唑	萘夫西林	药效降低，不良反应增加	文献报道，奥硝唑与呋布西林钠、萘夫西林钠、奥美拉唑、沃必唑、注射用炎琥宁、阿洛西林钠存在配伍禁忌，左奥硝唑在使用时也应注意
氢溴酸加兰他敏缓释片	红霉素	药效降低	与红霉素合用，可减低氢溴酸加兰他敏缓释片的疗效
氯唑西林	丙磺舒	药效提高	丙磺舒可减少氯唑西林的肾小管分泌、延长氯唑西林的血清半衰期
赛洛多辛	地尔硫卓	药效提高，不良反应增加	与CYP3A4抑制剂（例如地尔硫卓、红霉素、维拉帕米）并用，可能增加赛洛多辛的血药浓度，因此，合并用药时应谨慎并密切监测患者是否发生不良事件
维拉帕米	环磷酰胺	药效降低	细胞毒药物：环磷酰胺、长春新碱、甲基苄肼、强的松、长春碱酰胺、阿霉素、顺铂等可减少维拉帕米的吸收
联磺甲氧苄啶胶囊	环孢素	不良反应增加	联磺甲氧苄啶胶囊中的TMP与环孢素合用可增加肾毒性
盐酸普萘洛尔缓释片	利血平	不良反应增加	与抗高血压药物相互作用：盐酸普萘洛尔缓释片与利血平合用，可导致体位性低血压、心动过缓、头晕、晕厥
氨茶碱氯化钠	罗红霉素	药效提高，不良反应增加	与克林霉素、林可霉素及某些大环内酯类(红霉素、罗红霉素、克拉霉素)、喹诺酮类抗菌药(伊诺沙星、环丙沙星)合用时，可降低氨茶碱氯化钠在肝脏的清除率，使血药浓度升高，甚至出现毒性反应，应在给药时调整氨茶碱氯化钠的用量
环孢素	NSAIDs	药效提高	环孢素可能会使地高辛、秋水仙素、泼尼松龙、HMG-CoA还原酶抑制物（他汀类药物）和瑞格列奈、NSAIDs、西罗莫司、依托泊苷、阿利吉仑、波生坦或达比加群的清除率下降
西咪替丁	阿司匹林	药效提高	由于西咪替丁使胃液pH值升高，与四环素合用时，可致四环素的溶解速率下降、吸收减少、作用减弱（但西咪替丁的肝药酶抑制作用却可能增加四环素的血药浓度）；若与阿司匹林合用，则出现相反的结果，可使阿司匹林的作用增强
芬太尼	伊曲康唑	药效提高，不良反应增加	但实验资料表明CYP3A4抑制剂，如红霉素、酮康唑、伊曲康唑和tironavir会抑制舒芬太尼的代谢从而延长呼吸抑制作用
小儿复方磺胺甲噁唑	氨苯砜	药效提高，不良反应增加	不宜与氨苯砜合用，因氨苯砜与小儿复方磺胺甲噁唑中的TMP合用两者血药浓度均可升高，氨苯砜浓度的升高使不良反应增多且加重，尤其是高铁血红蛋白血症的发生
利多卡因	普萘洛尔	药效提高，不良反应增加	与西咪替丁以及β受体阻断剂如普萘洛尔、美托洛尔、纳多洛尔合用，利多卡因经肝脏代谢受抑制，利多卡因血浓度增加，可发生心脏和神经系统不良反应，应调整利多卡因剂量，并应用心电图监护及监测利多卡因血药浓度；
利托那韦	西沙必利	不良反应增加	阿普唑仑、安非他酮、胺碘酮、阿咪唑、苄替地尔、西沙必利、氯拉折帕、氯氮平、右丙氧芬、地西泮、二氢麦角胺、恩卡肢、舒乐安定、麦角胺、氟卡胺、氟西泮、咪达唑仑、哌替啶、匹莫齐特、吡罗昔康、普罗帕酮、奎尼丁、利福布丁、特非那定、三唑仑和左吡登禁止用于利托那韦治疗的病人，因为它们可能与利托那韦发生相互作用，产生严重并发症的危险
氟哌噻吨美利曲辛	肾上腺素	药效降低	肾上腺素神经阻断剂：氟哌噻吨美利曲辛可降低胍乙啶、倍他尼定、利舍平、可乐定、甲基多巴的抗高血压作用
阿苯达唑	西咪替丁	药效提高	西咪替丁抑制阿苯达唑的代谢
复方对乙酰氨基酚	甲氨蝶呤	药效提高	复方对乙酰氨基酚可加强口服降糖药及甲氨蝶呤的作用，不应同用
米诺环素	卡马西平	药效降低	由于巴比妥类、苯妥英或卡马西平可诱导微粒体酶的活性致使米诺环素的血药浓度降低，故合用时需调整米诺环素的剂量
氟哌噻吨美利曲辛	胍乙啶	药效降低	肾上腺素神经阻断剂：氟哌噻吨美利曲辛可降低胍乙啶、倍他尼定、利舍平、可乐定、甲基多巴的抗高血压作用
雌二醇	抗生素	药效降低	在罕见病例中，同时应用某些抗生素(如青霉素和四环素)时，会发生雌二醇水平下降
多拉司琼	利福平	药效提高	多拉司琼与西米替丁（细胞色素P-450非选择性抑制剂）合用7天时，氢化多拉司琼的血浓度升高24%，而与利福平（细胞色素P-450有效诱导剂）合用7天时，氢化多拉司琼的血浓度则降低28%
瑞素	胰岛素	药效提高，不良反应增加	口服降糖药(如磺脲类、双胍类)、胰岛素：由于潜在地降低胰岛素抵抗，瑞素可增强降糖药效果，具产生低血糖的风险(尤其在治疗初期，应仔细监测血糖水平)
舒托必利	乙醇	药效提高，不良反应增加	尽量避免合用：1乙醇：能增强舒托必利的镇静作用，警惕性降低可能造成开车或操作机器危险性
酮康唑	抗凝药	药效提高	酮康唑与华法林、香豆素、茚满二酮衍生物等抗凝药同时应用可增强其作用，导致凝血酶原时间延长，对患者应严密观察，监测凝血酶原时间，调整抗凝药的剂量
头孢呋辛	利尿剂	不良反应增加	对于正接受强效利尿剂如速尿并行治疗的患者，给予大剂量的头孢菌素类抗生素时应特别注意，因为如此合并使用，有对肾功能产生不良反应之虞，头孢呋辛临床使用经验证明，推荐剂量下使用，不致发生影响
巴瑞替尼	双氯芬酸	药效提高	虽然与OAT3抑制剂布洛芬和双氯芬酸的联合使用可能会导致巴瑞替尼的暴露量升高，但是，相对于丙磺舒，其OAT3的抑制能力较弱，因此预期无临床相关相互作用
利多卡因Ⅱ	普鲁卡因胺	药效提高，不良反应增加	与西咪替丁以及b受体阻断剂如，普萘洛尔、美托洛尔、纳多洛尔合用，利多卡因经肝脏代谢受抑制，利多卡因血浓度增加，可发生心脏和神经系统不良反应，应调整利多卡因剂量，并应心电图监护及监测利多卡因血药浓度；（2）巴比妥类药物可促进利多卡因代谢，两药合用可引起心动过缓，窦性停搏；（3）与普鲁卡因胺合用，可产生一过性谵妄及幻觉，但不影响利多卡因Ⅱ血药浓度；（4）异丙基肾上腺素因增加肝血流量，可使利多卡因Ⅱ的总清除率升高；去甲肾上腺素因减少肝血流量，可使利多卡因Ⅱ总清除率下降；（5）与下列药品有配伍禁忌：苯巴比妥，硫喷妥钠，硝普钠，甘露醇，两性霉素B，氨苄西林，磺胺嘧啶
氟哌噻吨美利曲辛胶囊	倍他尼定	药效降低	肾上腺素能神经阻断剂：氟哌噻吨美利曲辛胶囊可降低胍乙啶、倍他尼定、利舍平、可乐定、甲基多巴的抗高血压作用
环孢素	氟伐他汀	不良反应增加	从文献和上市后搜集的肌肉毒性病例来看，肌肉毒性包括肌痛、肌无力、肌炎、横纹肌溶解，与环孢素合并使用的药物包括洛伐他汀、辛伐他汀、阿托伐他汀、普伐他汀，与氟伐他汀合用时引起肌肉毒性的病例较为罕见
莫达非尼	卡马西平	药效提高	此外，由于莫达非尼的代谢消除部分与CYP3A4有关，与CYP3A4的强诱导剂（例如，卡马西平、苯巴比妥、利福平）或者强抑制剂（例如，酮康唑、伊曲康唑）合用会改变莫达非尼的血药浓度
头孢哌酮	抑肽酶	药效降低，不良反应增加	头孢哌酮与下列药物注射剂有配伍禁忌：阿米卡星、庆大霉素、卡那霉素B、多西环素、甲氯芬酯、阿马林(缓脉灵)、苯海拉明、门冬酸钾镁、盐酸羟嗪(安太乐)、普鲁卡因胺、氨茶碱、丙氯拉嗪、细胞色素C、喷他佐辛(镇痛新)、抑肽酶等
甲硝唑	苯妥英钠	药效降低	同时应用苯妥英钠、苯巴比妥等诱导肝微粒体酶的药物，加强甲硝唑代谢，使血药浓度下降，而苯妥英钠排泄减慢
卡马西平	达比加群	药效降低	合并使用卡马西平与直接作用的口服抗凝血药（利伐沙班、达比加群、阿哌沙班和依度沙班）可能导致直接作用的口服抗凝血药血浆浓度降低，这会引起血栓形成风险
利福平	安定	药效降低	利福平与地西泮（安定）合用可增加后者的消除，使其血药浓度减低，故需调整剂量
维生素E	抗凝药	药效提高	抗凝药：大量维生素A和维生素E与香豆素或茚满二酮衍生物同服，可导致凝血酶原降低
精氨酸阿司匹林	胰岛素	药效提高	胰岛素或口服降糖药物的降糖效果可因与精氨酸阿司匹林同用而加强和加速
西咪替丁	放射疗法	不良反应增加	西咪替丁可增强化疗药如：卡莫司汀、氟尿嘧啶、表柔比星或放射疗法的骨髓抑制作用（如：中性白细胞减少症，粒细胞缺乏症）
齐多夫定	磺胺甲恶唑	不良反应增加	与具有潜在肾毒性或骨髓抑制作用的药物，如全身用喷他咪、氨苯砜、乙胺嘧啶、复方磺胺甲恶唑、两性霉素、氟胞嘧啶、更昔洛韦、干扰素、长春新碱、长春花碱及阿霉素同时应用，特别在急性期治疗时亦可以使齐多夫定产生不良反应的机率增加
托拉塞米	丙磺舒	药效降低	非类固醇抗炎药（如吲哚美辛）和丙磺舒可降低托拉塞米的利尿和降压作用；
醋酸戈舍瑞林缓释植入剂	抗心律失常药物	不良反应增加	由于雄激素剥夺治疗可能延长QT间期，当醋酸戈舍瑞林缓释植入剂与已知可延长QT间期药物或可能会诱导尖端扭转型室性心动过速的药物如ⅠA类（如奎尼丁、丙吡胺）或Ⅲ类抗心律失常药物（如胺碘酮、索他洛尔、多非利特、伊布利特）、美沙酮、莫西沙星、抗精神病药物等合用时，应谨慎评估（详见【注意事项】）
氯化钠	甲氨蝶呤	药效降低	氯化钠与碱性注射液（如呋喃苯胺酸、甲氨蝶呤、氟尿嘧啶、吡咯他尼注射液）或鬼臼乙叉甙注射液配伍会发生浑浊或结晶析出，故不宜与上述药物同时应用
鞣酸蛋白片	胰酶	药效降低	鞣酸蛋白片能影响胰酶、胃蛋白酶、乳酶生等的药效，不宜同服
对乙酰氨基酚	巴比妥类	不良反应增加	应用巴比妥类（如苯比妥）或解痉药（如颠茄）的患者，长期使用对乙酰氨基酚时可至肝脏损害，故不应同服
加替沙星	地丹诺辛	药效降低	硫酸亚铁，含铝或镁制酸剂和去羟基苷(地丹诺辛，惠妥兹)与加替沙星合用，加替沙星的生物利用度降低
异丙托溴铵气雾剂	茶碱	药效提高	使用β-肾上腺素能兴奋剂或黄嘌呤类制剂(如茶碱)可加强异丙托溴铵气雾剂的作用
非诺贝特	氟伐他汀	药效提高	非诺贝特应慎与HMG-CoA还原酶抑制剂，如普伐他汀、氟伐他汀、辛伐他汀等合用，可引起肌痛、横纹肌溶解、血肌酸磷酸激酶增髙等肌病，严重时应停药
氨酚氯雷伪麻缓释片	利血平	药效降低	复方降压片、甲基多巴、利血平和藜芦生物碱等与氨酚氯雷伪麻缓释片所含硫酸伪麻黄碱合用时，前者的抗高血压作用可能会有所降低
异丙嗪	降压药	药效提高	盐酸异丙嗪能加强降压药的降压作用
加替沙星	镁	药效降低	硫酸亚铁、含铝或镁制酸剂和去羟基苷(地丹诺辛、惠妥兹)与加替沙星合用，加替沙星的生物利用度会降低
加替沙星	西米替丁	药效降低	抗肿瘤类药物，以及组胺H2受体拮抗剂(如西米替丁)与加替沙星同时使用，降低加替沙星的吸收
棕榈氯霉素(B型)	阿芬他尼	药效降低	如在术前或术中应用，由于棕榈氯霉素(B型)对肝酶的抑制作用，可降低诱导麻醉药阿芬他尼的清除，延长其作用时间
利福喷丁	咪康唑	药效降低	与咪康唑或酮康唑合用，可使后两者血药浓度减低，故利福喷丁不宜与咪唑类合用
维生素E	氢氧化铝	药效降低	氢氧化铝可使小肠上段的胆酸沉淀，降低脂溶性维生素E的吸收
复方葡萄糖酸钙口服溶液	噻嗪类利尿药	不良反应增加	复方葡萄糖酸钙口服溶液与噻嗪类利尿药合用时，易发生高钙血症
诺氟沙星	镁	药效降低	去羟肌苷可减少诺氟沙星的口服吸收，因其制剂中含铝及镁，可与氟喹诺酮类螯合，故不宜合用
青霉素	口服避孕药	药效降低	青霉素可刺激雌激素代谢或减少其肠肝循环，因此可降低口服避孕药的效果
氢氯噻嗪	考来烯胺	药效降低	考来烯胺(消胆胺)和考来替泊(降胆宁)树脂：阴离子交换树脂会削弱氢氯噻嗪的吸收
维生素A	新霉素	药效降低	考来烯胺(colestyramine)、矿物油、新霉素、硫糖铝能干扰维生素A吸收
维生素B12	苯巴比妥	药效降低	氨基糖苷类抗生素、对氨基水杨酸类、苯巴比妥、苯妥英钠、扑米酮等抗惊厥药及秋水仙碱等可减少维生素B12从肠道的吸收
舒他西林	保泰松	药效提高，不良反应增加	丙磺舒、阿司匹林、吲哚美辛、保泰松、磺胺药可减少舒他西林在肾小管的排泄，因而使舒他西林的血药浓度升高，血消除半衰期（t1/2β）延长，毒性也可能增加
三维葡磷钙咀嚼片	苯妥英钠	药效降低	三维葡磷钙咀嚼片与苯妥英钠类、四环素类药物同用，二者吸收均减少
甲氨蝶呤	新霉素	药效提高	口服卡那霉素可增加口服甲氨蝶呤的吸收，而口服新霉素钠可减少其吸收；
多维铁口服溶液	卡比多巴	药效降低	多维铁口服溶液可减少左旋多巴、卡比多巴、甲基多巴及喹诺酮类药物的吸收
巴氨西林	雌激素	药效降低	巴氨西林可刺激雌激素代谢或减少其肠肝循环，因此可降低口服避孕药的效果
头孢拉定	丙磺舒	药效提高	丙磺舒可延迟头孢拉定肾排泄
小诺霉素	磺胺嘧啶	药效降低，不良反应增加	诺霉素不宜与两性霉素B、头孢噻吩钠、呋喃妥因钠、磺胺嘧啶钠和盐酸四环素等（以上均为注射液）联合应用，因可发生配伍禁忌
文拉法辛	奎尼丁	不良反应增加	与奎尼丁合用时，可使文拉法辛血药浓度升高
阿司匹林	乙酰唑胺	药效提高	乙酰唑胺：阿司匹林与乙酰唑胺共用时，由于它们在肾小管竞争性排泄，可导致乙酰唑胺血清浓度升高
司帕沙星	镁	药效降低	司帕沙星与含有铝、镁、铁的抗酸药和硫糖铝合用时，可降低司帕沙星的吸收，从而降低疗效，若需服用应间隔4小时
利福平	糖皮质激素	药效降低	肾上腺皮质激素（糖皮质激素、盐皮质激素）、抗凝药、香豆素或茚满二酮衍生物、口服降血糖药、促皮质激素、氨苯砜、洋地黄苷类、丙吡胺、奎尼丁等与利福平合用时，由于后者对肝微粒体酶活性的刺激作用，可使上述药物的药效减低，因此除地高辛和氨苯砜外，在用利福平前和疗程中上述药物需调整剂量
利多卡因	硫喷妥钠	药效提高，不良反应增加	与西咪替丁以及b受体阻断剂如，普萘洛尔、美托洛尔、纳多洛尔合用，利多卡因经肝脏代谢受抑制，利多卡因血浓度增加，可发生心脏和神经系统不良反应，应调整利多卡因剂量，并应心电图监护及监测利多卡因血药浓度；（2）巴比妥类药物可促进利多卡因代谢，两药合用可引起心动过缓，窦性停搏；（3）与普鲁卡因胺合用，可产生一过性谵妄及幻觉，但不影响利多卡因血药浓度；（4）异丙基肾上腺素因增加肝血流量，可使利多卡因的总清除率升高；去甲肾上腺素因减少肝血流量，可使利多卡因总清除率下降；（5）与下列药品有配伍禁忌：苯巴比妥，硫喷妥钠，硝普钠，甘露醇，两性霉素B，氨苄西林，磺胺嘧啶
卢帕他定	红霉素	药效提高	与酮康唑或红霉素的相互作用：卢帕他定20mg与酮康唑或红霉素一起服用后，全身暴露量将分别升高10倍和2～3倍
复方锌铁钙颗粒	磷酸盐	药效降低	复方锌铁钙颗粒与磷酸盐类、四环素类及鞣酸等同服，可妨碍复方锌铁钙颗粒的吸收
布地奈德	奈非那韦	药效提高，不良反应增加	布地奈德的代谢转化可被由CYP3A4代谢的物质（例如伊曲康唑、酮康唑、利托那韦、奈非那韦、环孢素、炔雌醇和醋竹桃霉素）所抑制
莫达非尼	三唑仑	药效降低	三唑仑的平均最大浓度值Cmax和曲线下面积AUC0-∞均值分别下降了42％和59％，在莫达非尼治疗后三唑仑的消除半衰期大约缩短了一个小时
克拉霉素	地高辛	药效提高	在上市后监测中也有报道同时使用克拉霉素和地高辛的患者，其地高辛的血清浓度升高
利福平	洋地黄苷类	药效降低	肾上腺皮质激素（糖皮质激素、盐皮质激素）、抗凝药、香豆素或茚满二酮衍生物、口服降血糖药、促皮质激素、氨苯砜、洋地黄苷类、丙吡胺、奎尼丁等与利福平合用时，由于后者对肝微粒体酶活性的刺激作用，可使上述药物的药效减低，因此除地高辛和氨苯砜外，在用利福平前和疗程中上述药物需调整剂量
盐酸氨溴索口腔崩解片	红霉素	药效提高	盐酸氨溴索口腔崩解片与抗生素（阿莫西林、头孢呋新、红霉素、强力霉素）同时服用，可导致抗生素在肺组织浓度升高
硝酸甘油	肝素	药效降低	·与硝酸甘油软膏合用时，肝素的疗效可能减弱；
阿莫西林肠溶片	糖皮质激素	不良反应增加	阿莫西林肠溶片与糖皮质激素（如地塞米松等）同用，可增加胃肠道不良反应
碳酸钙片	噻嗪类利尿药	药效提高，不良反应增加	碳酸钙片与噻嗪类利尿药合用时，易发生髙钙血症（因增加肾小管对钙的重吸收）
雷米普利	胰岛素	药效提高，不良反应增加	口服降糖药(如磺脲类、双胍类)、胰岛素：由于潜在地降低胰岛素抵抗，雷米普利可增强降糖药效果，具产生低血糖的风险(尤其在治疗初期，应仔细监测血糖水平)
多维铁口服溶液	喹诺酮类	药效降低	多维铁口服溶液可减少左旋多巴、卡比多巴、甲基多巴及喹诺酮类药物的吸收
甲氨蝶呤	卡那霉素	药效提高	口服卡那霉素可增加口服甲氨蝶呤的吸收，而口服新霉素钠可减少其吸收；
复方普萘洛尔咖啡因	异烟肼	药效提高，不良反应增加	与抗凝剂如香豆素类或氯霉素、异烟肼、保泰松、磺胺类合用，可减低复方普萘洛尔咖啡因的代谢，可能增加复方普萘洛尔咖啡因的毒性
利托那韦	哌替啶	不良反应增加	阿普唑仑、安非他酮、胺碘酮、阿咪唑、苄替地尔、西沙必利、氯拉折帕、氯氮平、右丙氧芬、地西泮、二氢麦角胺、恩卡肢、舒乐安定、麦角胺、氟卡胺、氟西泮、咪达唑仑、哌替啶、匹莫齐特、吡罗昔康、普罗帕酮、奎尼丁、利福布丁、特非那定、三唑仑和左吡登禁止用于利托那韦治疗的病人，因为它们可能与利托那韦发生相互作用，产生严重并发症的危险
五维甘草那敏胶囊	异烟肼	药效降低	五维甘草那敏胶囊中烟酰胺与异烟肼有拮抗作用
唑吡坦	利福平	药效降低	利福平可以使唑吡坦的AUC降低73%、Cmax降低58%、t1/2降低36%，并能显著降低唑吡坦的药效
美托洛尔	利血平	药效提高	与西咪替丁合用或预先使用奎尼丁均可增加美托洛尔的血浆浓度；与利血平合用可增强美托洛尔作用，需注意低血压与心动过速
比索洛尔	吩噻嗪	药效提高	抗高血压药物及其它有降压作用的药物（如三环类抗抑郁药、巴比妥类、吩噻嗪）可能会增强比索洛尔的降血压作用
布洛伪麻那敏混悬液	肝素	药效提高，不良反应增加	布洛伪麻那敏混悬液与肝素、双香豆素等抗凝血药合用时，可导致凝血酶原时间延长，增加出血倾向
阿利吉仑	氨氯地平	药效降低	当阿利吉仑与以下药物联合使用时，可见阿利吉仑的Cmax或AUC出现20-30％的改变：缬沙坦（降低28％）、二甲双胍（降低28％）、氨氯地平（升高29％）和西米替丁（升高19％）
头孢泊肟	抗生素	药效提高	与其它β－内酰胺类抗生素类似，同时服用丙磺舒，会抑制头孢泊肟从肾脏排泄，导致AUC和Cmax升高
维生素E	维生素A	药效提高	维生素E可促进维生素A的吸收、利用与贮存
戊酸雌二醇	四环素	药效降低	联合服用活性炭和/或抗生素，例如氨苄西林或四环素后，可观察到肠道菌群改变导致药物浓度下降，可能导致戊酸雌二醇片的疗效减退
吗啡	吩噻嗪类	不良反应增加	对中枢神经系统起抑制作用的吩噻嗪类镇吐药与吗啡伍用，可导致严重的呼吸和循环抑制，产生不良反应或延长睡眠；
头孢米诺	呋喃苯胺酸	不良反应增加	本口与氨茶碱、磷酸吡哆醛配伍会降低效价或着色，故不得配伍；与呋喃硫胺、硫辛酸，氢化可的松琥珀酸钠及腺苷钴胺配伍后时间稍长会变色，故配伍后应尽快使用；与利尿剂呋(呋喃苯胺酸等)等合用有可能增加肾毒性，应谨慎使用，动物实验证实，头孢米诺影响酒精代谢，使血中乙醛浓度上升，显示双硫仑样作用，故用药期间或用药后应禁酒
苯扎贝特	呋塞米	药效提高	苯扎贝特与其它高蛋白结合率的药物合用时，也可将它们从蛋白结合位点上替换下来，导致其作用加强，如甲苯磺丁脲及其它磺脲类降糖药、苯妥英、呋塞米等，在降血脂治疗期间服用上述药物，则应调整降糖药及其它药的剂量
黄体酮	酮康唑	药效提高	酮康唑是细胞色素P450酶的抑制剂，因此，酮康唑或其它细胞色素酶的抱制剂可能增加黄体酮的血药浓度
维生素K4	双香豆素	药效降低	口服抗凝剂（如双香豆素类）可拮抗维生素K4作用
咪达唑仑	哌替啶	药效提高	给药前应用吗啡，哌替啶，芬太尼使静脉注射咪达唑仑的镇静作用增强，必须根据给药前用药量来调整咪达唑仑的用量
地奈德	酮康唑	药效提高	口服酮康唑(一种强效CYP3A4抑制剂)后，会导致口服布地奈德平均血浆药物浓度增加
苯妥英钠	对乙酰氨基酚	药效降低，不良反应增加	长期应用对乙酰氨基酚患者应用苯妥英钠可增加肝脏中毒的危险，并且疗效降低
氯化钠	氟氧头孢	药效降低	氯化钠与鬼臼乙叉甙注射液或氟氧头孢钠注射液配伍使用可能会使氯化钠的含量降低，故应在配制后6小时内使用
儿童维D钙咀嚼片	四环素	药效降低	儿童维D钙咀嚼片与苯妥英钠类及四环素同用，二者吸收减低
氧	间羟胺	药效降低，不良反应增加	氧与氨基糖苷类、去甲肾上腺素、间羟胺、苯巴比妥、维生素B族、维生素C等药物存在配伍禁忌，不宜同瓶滴注
氨氯地平	硝酸甘油	药效提高	⒀舌下硝酸甘油和长效硝酸酯制剂：与氨氯地平合用可加强抗心绞痛效应
麻黄碱	洋地黄苷类	不良反应增加	麻黄碱与洋地黄苷类合用，可致心律失常
维D2磷葡钙片	苯妥英钠	药效降低	维D2磷葡钙片与苯妥英钠类及四环素类同用，二者吸收减低
利多卡因	美托洛尔	药效提高，不良反应增加	与西咪替丁以及β受体阻断剂如，普萘洛尔、美托洛尔、纳多洛尔合用，利多卡因经肝脏代谢受抑制，利多卡因血浓度增加，可发生心脏和神经系统不良反应，应调整利多卡因剂量，并应心电图监护及监测利多卡因血药浓度；
赖诺普利	利尿剂	不良反应增加	在开使用赖诺普利治疗前通过停用利尿剂，可大大减少症状低血压的可能性
替硝唑	苯巴比妥	药效降低	同时应用苯妥英钠、苯巴比妥等诱导肝微粒体酶的药物，可加强替硝唑代谢，使血药浓度下降，而苯妥英钠排泄缓慢
丙哌维林	吩噻嗪	药效提高	丙哌维林与三环抗抑郁药（比如丙咪嗪）、镇静剂（比如苯二氮卓类）、抗胆碱能药（全身使用）、金刚烷胺、神经镇静药（比如吩噻嗪系）和β-肾上腺素受体激动药（β-拟交感神经药）等联合用药，疗效增强
普萘洛尔	消胆胺	药效降低	与消胆胺或考来替泊合用，使普萘洛尔浓度降低达50%
利多卡因	西咪替丁	药效提高，不良反应增加	与西咪替丁以及β受体阻断剂如普萘洛尔、美托洛尔、纳多洛尔合用，利多卡因经肝脏代谢受抑制，利多卡因血浓度增加，可发生心脏和神经系统不良反应，应调整利多卡因剂量，并应用心电图监护及监测利多卡因血药浓度；
蒿甲醚	利福平	药效降低	在6例不伴有疟疾的HIV-1与结核共同感染的成人中，与单独给药后的暴露值相比较，口服给予强CYP3A4诱导剂利福平（每日600mg）与蒿甲醚（6次给药方案给药3天）导致蒿甲醚、DHA和本芴醇的暴露显著下降，分别为原暴露量的89%、85%和68%
米氮平	卡马西平	药效降低	酮康唑：健康男性受试者(n=24)中，卡马西平(400mg，2次/天)使米氮平(15mg,2次/天)的清除率增加约2倍，导致米氮平的平均血浆浓度降低60%
卡那霉素	头孢噻吩	药效降低，不良反应增加	卡那霉素不宜与两性霉素B、头孢噻吩、磺胺嘧啶和四环素等注射剂联合应用，因可发生配伍禁忌
罗红霉素Ⅱ	安定	药效提高	咪唑安定：罗红霉素Ⅱ可增加咪唑安定曲线下面积，延长其半衰期
苯扎贝特	甲苯磺丁脲	药效提高	苯扎贝特与其它高蛋白结合率的药物合用时，也可将它们从蛋白结合位点上替换下来，导致其作用加强，如甲苯磺丁脲及其它磺脲类降糖药、苯妥英、呋塞米等，在降血脂治疗期间服用上述药物，则应调整降糖药及其它药的剂量
培氟沙星	抗凝药	药效提高	培氟沙星与抗凝药华法林同用时可增强后者的抗凝作用合用时应严密监测患者的凝血酶原时间，并调整剂量
颠茄	甲氧氯普胺	药效降低	13、与甲氧氯普胺伍用时，其促进胃肠运动的作用可被颠茄所拮抗
氨酚异丙嗪	巴比妥类	不良反应增加	在长期饮酒或应用其他肝酶诱导剂，尤其是应用巴比妥类或抗惊厥药的患者，长期使用氨酚异丙嗪时，更有发生肝脏毒性的危险
二氟尼柳	萘普生	药效提高	二氟尼柳与萘普生同用时，可显著降低萘普生及代谢产物自尿中的排泄
美洛昔康	消胆胺	药效降低	在胃肠道中消胆胺与美洛昔康结合可加快美洛昔康的排除
达比加群	利福平	药效降低	利福平：在达比加群酯给药前给予诱导物利福平600mg每日一次连续七天，可使达比加群暴露峰值和暴露总量分别降低65.5%和67%
利多卡因	西咪替丁	药效提高，不良反应增加	与西咪替丁以及β-受体阻断剂如，普萘洛尔、美托洛尔、纳多洛尔合用，利多卡因经肝脏代谢受抑制，利多卡因血浓度增加，可发生心脏和神经系统不良反应，应调整利多卡因剂量，并应心电图监护及监测利多卡因血药浓度；
西米替丁	阿司匹林	药效降低	由于西米替丁使胃液pH值升高，与四环素合用时，可致四环素的溶解速率下降、吸收减少、作用减弱（但西米替丁的肝药酶抑制作用却可能增加四环素的血药浓度）；若与阿司匹林合用，则出现相反的结果，可使阿司匹林的作用增强
复方头孢克洛干混悬剂	布美他尼	不良反应增加	呋塞米、依他尼酸、布美他尼等强利尿药，卡氮芥、链佐星等抗肿瘤药及氨基糖苷类抗生素等肾毒性药物与复方头孢克洛干混悬剂合用有增加肾毒性的可能
青霉素	口服避孕药	药效降低	霉素可刺激雌激素代谢或减少其肠肝循环，因此可降低口服避孕药的效果
氨丁三醇	丙磺舒	药效提高	氨丁三醇不应与丙磺舒同用，因后者可明显降低氨丁三醇肾脏清除率（降低66%）和蛋白结合率（降低28%），导致血药浓度增高
布洛芬	华法林	药效提高，不良反应增加	布洛芬与肝素、双香豆素类（如华法林）等抗凝药同用时，可导致凝血酶原时间延长，增加出血倾向
布洛芬	肝素	药效提高，不良反应增加	布洛芬与肝素、双香豆素（如华法林）等抗凝药同用时，可导致凝血酶原时间延长，增加出血倾向
酮康唑	华法林	药效提高	酮康唑与华法林、香豆素、茚满二酮衍生物等抗凝药同时应用可增强其作用，导致凝血酶原时间延长，对患者应严密观察，监测凝血酶原时间，调整抗凝药的剂量
曲马多Ⅱ	丁丙诺啡	药效降低	激动剂/拮抗剂混合物（如丁丙诺啡、纳布啡、镇痛新）与曲马多Ⅱ联合用药是不可取的，因为从理论上讲在这种情况下纯激动剂的止痛效果下降
维U颠茄铝Ⅱ	丙卡巴肼	不良反应增加	维U颠茄铝Ⅱ与单胺氧化酶(MAO)抑制剂、呋喃唑酮、丙卡巴肼等合用时，颠茄在肝脏的解毒被阻断，因而加强了其抗M胆碱作用的不良反应，另外，此种抑制剂本身也有抗M胆碱作用
呋喃唑酮	苯巴比妥	药效降低	同时应用苯妥英钠、苯巴比妥等诱导肝微粒体酶的药物，可加强呋喃唑酮代谢，使血药浓度下降，而苯妥英钠排泄减慢
双氯芬酸Ⅰ	甲氨喋呤	药效提高，不良反应增加	双氯芬酸Ⅰ可降低甲氨蝶呤的排泄，增高其血浓度，甚至可达中毒水平，故双氯芬酸Ⅰ不应与中或大剂量甲氨喋呤同用
阿扎司琼	氟氧头孢	药效降低	阿扎司琼与鬼臼乙叉甙注射液或氟氧头孢钠注射液配伍使用可能会使阿扎司琼的含量降低，故应在配制后6小时内使用
氨溴索	阿莫西林	药效提高	氨溴索与抗生素（阿莫西林、头孢呋辛、红霉素、强力霉素）同时服用，可导致抗生素在肺组织浓度升高
利福霉素	咪康唑	药效降低	利福平与咪康唑或酮康唑合用，可使后两者血药浓度减低，故利福霉素不宜与咪唑类合用
头孢米诺	氢化可的松	不良反应增加	本口与氨茶碱、磷酸吡哆醛配伍会降低效价或着色，故不得配伍；与呋喃硫胺、硫辛酸，氢化可的松琥珀酸钠及腺苷钴胺配伍后时间稍长会变色，故配伍后应尽快使用；与利尿剂呋(呋喃苯胺酸等)等合用有可能增加肾毒性，应谨慎使用，动物实验证实，头孢米诺影响酒精代谢，使血中乙醛浓度上升，显示双硫仑样作用，故用药期间或用药后应禁酒
青霉素	华法林	药效提高	霉素可加强华法林的作用
文拉法辛	酮康唑	药效提高	合并使用CYP3A4抑制剂和文拉法辛可能会升高文拉法辛和ODV水平(见[药物相互作用]-酮康唑)
麻黄碱	麦角新碱	药效提高，不良反应增加	麻黄碱与麦角新碱，麦角胺或缩宫素合用，可加剧血管收缩，导致严重高血压或外周组织缺血
他克莫司	氨苯砜	药效提高，不良反应增加	已知会抑制细胞色素P4503A4酶系统的药物：根据体外试验，下列药物可以视为他克莫司代谢的潜在性抑制剂：溴麦亭、可的松、氨苯砜、麦角胺、乙炔雌二醇、甲地孕酮、依他康唑、交沙霉素、利多卡因、甲妥因、咪康唑、尼卡地平、尼鲁地平、尼伐地平、炔诺酮、奎尼丁、他莫昔芬、三醋酸竹桃霉素、维拉帕米
复方锌铁钙颗粒	四环素类	药效降低	复方锌铁钙颗粒与磷酸盐类、四环素类及鞣酸等同服，可妨碍复方锌铁钙颗粒的吸收
氨氯地平	蛋白酶抑制剂	药效提高	CYP3A4抑制剂：联合使用氨氯地平和强效或中效CYP3A4抑制剂（蛋白酶抑制剂、唑类杀真菌剂、大环内酯类，如红霉素或克拉霉素等、维拉帕米或地尔硫䓬）可能导致氨氯地平暴露量显著增加
氨氯地平	辛伐他汀	药效提高	辛伐他汀：多剂量10mg氨氯地平和80mg辛伐他汀合并给药与单独给予辛伐他汀相比辛伐他汀的暴露升高77%，建议氨氯地平给药患者辛伐他汀的剂量限制到每天20mg
氯化琥珀胆碱	普鲁卡因胺	药效提高	与下列药物合用也须谨慎，如：吩噻嗪类、普鲁卡因胺、奎尼丁、卡那霉素、多粘菌素B、新霉素等有去极化型肌松作用，能增强氯化琥珀胆碱作用
布洛芬泡腾片	抗凝药	药效提高，不良反应增加	布洛芬泡腾片与肝素，双香豆素等抗凝药同用时，可导致凝血酶原时间延长，增加出血倾向
利福定	环磷酰胺	药效降低，不良反应增加	利福定可诱导肝微粒体酶，增加抗肿瘤药达卡巴嗪(dacarbazine)、环磷酰胺的代谢，形成烷化代谢物，促使白细胞减低，因此需调整剂量
利福平	孕激素	药效降低	据报道利福平可加快下列药物的代谢：抗惊厥药(如苯妥英)，抗心律失常药(如双异丙吡按、美西律、奎尼丁、妥卡尼)，口服抗凝血药，抗真菌药(如氟康唑、伊曲康唑、酮康唑等)，巴比土酸盐，β-阻滞剂，钙离子阻滞剂(如硫氮卓酮、硝苯吡啶、维拉帕米等)，氯霉素、克拉霉素、皮质类固醇、环孢霉素、洋地黄甙类、氯贝特、激素类避孕药，氨苯砜、安定、强力霉素、氟喹诺酮类(如环丙沙星)、氟哌啶醇、口服降糖药(磺酰脲)，左旋甲状腺素、美沙酮、麻醉性镇痛药，去甲替林、孕激素、奎林、茶碱、他克莫司、三环类抗抑郁药(阿米替林、去甲替林)和叠氮胸苷
美洛西林	丙磺舒	药效提高，不良反应增加	丙磺舒、阿司匹林、吲哚美辛、保泰松、磺胺药可减少美洛西林自肾脏排泄，因此与美洛西林合用时使其血药浓度增高，排泄时间延长，毒性也可能增加
布洛伪麻干混悬剂	地高辛	药效提高，不良反应增加	布洛伪麻干混悬剂与地高辛、甲氨蝶呤、口服降糖药同时服用，能使这些药物的血药浓度增高，不良反应增加
辛伐他汀片	烟酸	不良反应增加	辛伐他汀片与甲基羟戊二酰辅酶A(HMG-COA)还原酶抑制剂合并用药会增加肌病的发生率和严重程度，这些药物包括吉非贝齐和其他贝特类，以及降脂剂量的烟酸(大于等于1g/d)
酮康唑	多非利特	不良反应增加	-由于酮康唑与CYP3A4底物合用会增加这些药物的血浆浓度，而可能导致QT间期延长和个别出现尖端扭转型室速，因此酮康唑禁止与下列药物合用：特非那丁、苄普地尔、阿司咪唑、卤泛群、左醋美沙朵(左美沙酮)、咪唑斯汀、西沙必利、多非利特、奎尼丁、匹莫齐特、苯丙胺、舍吲哚；
依诺沙星	抗凝药	药效提高，不良反应增加	依诺沙星与抗凝药华法林合用时可增强后者的抗凝作用，故应避免二者合用
干扰素	茶碱	药效提高	在同一研究中，发现茶碱的AUC(表示细胞色素P4501A2活性的指标)出现了25%的升高，表明干扰素可中度抑制细胞色素P4501A2的活性
单硝酸异山梨酯Ⅱ	双氢麦角胺	药效提高	单硝酸异山梨酯Ⅱ可增强双氢麦角胺的升血压效应
复方愈创木酚磺酸钾	降压药	药效提高	溴苯胺、胍乙啶等降压药与复方愈创木酚磺酸钾同用时，前者的降压，效应可能增强，肾上腺素与复方愈创木酚磺酸钾同用时，肾上腺素的a作用被阻断，而使β作用占优势
洛芬葡锌那敏	肝素	药效提高，不良反应增加	芬葡锌那敏与肝素、双香豆素等抗凝药物同用时，可导致凝血酶原时间延长，增加出血倾向，不宜同用
右旋糖酐铁口服溶液	左旋多巴	药效降低	右旋糖酐铁口服溶液可减少左旋多巴、卡比多巴、甲基多巴及喹诺酮类药物的吸收；4.如正在服用其它药品，使用右旋糖酐铁口服溶液前请咨询医师或药师
氯苯那敏	金刚烷胺	药效提高	氯苯那敏可增强金刚烷胺、抗胆碱药、氟哌啶醇、吩噻嗪类以及拟交感神经药等的作用
利多卡因Ⅱ	巴比妥类	药效提高，不良反应增加	与西咪替丁以及b受体阻断剂如，普萘洛尔、美托洛尔、纳多洛尔合用，利多卡因经肝脏代谢受抑制，利多卡因血浓度增加，可发生心脏和神经系统不良反应，应调整利多卡因剂量，并应心电图监护及监测利多卡因血药浓度；（2）巴比妥类药物可促进利多卡因代谢，两药合用可引起心动过缓，窦性停搏；（3）与普鲁卡因胺合用，可产生一过性谵妄及幻觉，但不影响利多卡因Ⅱ血药浓度；（4）异丙基肾上腺素因增加肝血流量，可使利多卡因Ⅱ的总清除率升高；去甲肾上腺素因减少肝血流量，可使利多卡因Ⅱ总清除率下降；（5）与下列药品有配伍禁忌：苯巴比妥，硫喷妥钠，硝普钠，甘露醇，两性霉素B，氨苄西林，磺胺嘧啶
培氟沙星	抗凝药	药效提高	培氟沙星与抗凝药华法林同用时可增强后者的抗凝作用，合用时应严密监测患者的凝血酶原时间，并调整剂量
利福平滴眼液	普罗帕酮	药效降低	肾上腺皮质激素(糖皮质激素﹑盐皮质激素)﹑抗凝药﹑氨茶碱﹑茶碱﹑氯霉素﹑氯贝丁酯﹑环胞素﹑维拉帕米(异搏定)﹑妥卡尼﹑普罗帕酮﹑甲氧苄啶﹑香豆素或茚满二酮衍生物﹑口服降血糖药﹑促皮质素﹑氨苯砜﹑洋地黄苷类﹑丙吡胺﹑奎尼丁等与利福平合用时，由于后者诱导肝微粒体酶活性，可使上述药物的药效减弱，因此除地高辛和氨苯砜外，在用利福平前和疗程中上述药物需调整剂量，利福平滴眼液与香豆素或茚满二酮类合用时应每日或定期测定凝血酶原时间，据以调整剂量
阿司待因	磺吡酮	药效降低	阿司待因可减弱以下效应：促尿酸排泄剂如丙磺舒和磺吡酮
普萘洛尔	安替比林	药效提高	与安替比林、茶碱类和利多卡因合用可降低普萘洛尔清除率
单硝酸异山梨酯缓释胶囊(IV)	精神安定剂	药效提高	同时服用具降血压作用的药物，如β-受体阻滞剂、钙通道阻滞剂、血管扩张药和/或酒精，精神安定剂，三环类抗抑郁药可增强单硝酸异山梨酯缓释胶囊(IV)的降血压作用
加拉碘铵	多肽类抗生素	药效提高	多肽类抗生素可增加或延长加拉碘铵的神经肌肉阻滞作用
非洛地平	西咪替丁	药效提高	西咪替丁：西咪替丁与非洛地平合用使非洛地平的Cmax和AUC增加约55％
利托那韦口服溶液	特非那定	不良反应增加	阿普唑仑、安非他酮、胺碘酮、阿咪唑、苄替地尔、西沙必利、氯拉折帕、氯氮平、右丙氧芬、地西泮、二氢麦角胺、恩卡肢、舒乐安定、麦角胺、氟卡胺、氟西泮、咪达唑仑、哌替啶、匹莫齐特、吡罗昔康、普罗帕酮、奎尼丁、利福布丁、特非那定、三唑仑和左吡登禁止用于利托那韦口服溶液治疗的病人，因为它们可能与利托那韦口服溶液发生相互作用，产生严重并发症的危险
硝苯地平	印地那韦	药效提高	另外，印地那韦和利托那韦在体外可抑制细胞色素P4503A4介导的硝苯地平的代谢
米氮平	利福平	药效降低	当苯妥英，卡马西平或其他的肝代谢诱导剂（如利福平）与米氮平同用时，米氮平的剂量可能需要增加
硫酸亚铁糖浆	磷酸盐	药效降低	硫酸亚铁糖浆与磷酸盐类、四环素类及鞣酸等同服，可妨碍铁的吸收
依非韦伦	舍曲林	药效降低	当联合服用舍曲林和依非韦伦时，应增加舍曲林的剂量以补偿由依非韦伦诱导的舍曲林的代谢异常
利福平滴眼液	妥卡尼	药效降低	肾上腺皮质激素(糖皮质激素﹑盐皮质激素)﹑抗凝药﹑氨茶碱﹑茶碱﹑氯霉素﹑氯贝丁酯﹑环胞素﹑维拉帕米(异搏定)﹑妥卡尼﹑普罗帕酮﹑甲氧苄啶﹑香豆素或茚满二酮衍生物﹑口服降血糖药﹑促皮质素﹑氨苯砜﹑洋地黄苷类﹑丙吡胺﹑奎尼丁等与利福平合用时，由于后者诱导肝微粒体酶活性，可使上述药物的药效减弱，因此除地高辛和氨苯砜外，在用利福平前和疗程中上述药物需调整剂量，利福平滴眼液与香豆素或茚满二酮类合用时应每日或定期测定凝血酶原时间，据以调整剂量
异丙嗪	溴苄铵	药效提高	溴苄铵、异喹胍或胍乙啶等降压药与异丙嗪同用时，前者的降压效应增强
枸橼酸铁铵	维生素C	药效提高，不良反应增加	与维生素C同服，可增加枸橼酸铁铵吸收，但也易致胃肠道反应
溴苄铵	多巴胺	不良反应增加	溴苄铵阻止肾上腺素能神经末梢再摄取儿茶酚胺，故对肾上腺素，去甲肾上腺素及多巴胺很敏感，合用可使血压明显升高
他唑巴坦	氨基糖苷类抗生素	药效降低，不良反应增加	但他唑巴坦与氨基糖苷类抗生素之间存在物理性配伍禁忌，因此两种药液不能直接混合
咪康唑	苯妥英钠	药效降低	苯妥英钠与咪康唑合用可引起两种药物代谢的改变，并使咪康唑的达峰时间延迟，两药合用时应严密观察其反应
硝酸异山梨酯注射液	利尿剂	药效提高	合并服用具有降低血压作用的药物，例如血管舒张药、降压药(如β-肾上腺素受体阻滞剂、利尿剂、钙通道阻滞剂、ACE抑制剂)、神经松弛剂或三环类抗抑郁药以及酒精，可能会增强硝酸异山梨酯注射液的降压作用
环孢素软胶囊	安乃近	药效降低	降低环孢素软胶囊血浆或全血浓度的有：巴比妥类药物、异烟肼、安乃近、卡马西平、苯妥英、Metamizole、利福平、萘夫西林、西咪替丁、磺胺二甲嘧啶注射剂、甲氧苄啶注射剂、曲格列酮、普罗布考、奥曲肽、贯叶连翘含有制剂、噻氯匹定
谷氨酸诺氟沙星氯化钠	茶碱类	药效提高，不良反应增加	谷氨酸诺氟沙星氯化钠与茶碱类合用时可能由于与细胞色素P450结合部位的竞争性抑制，导致茶碱类的肝清除明显减少，血消除半衰期延长，血药浓度升高，出现茶碱中毒症状，如恶心、呕吐、震颤、不安、激动、抽搐、心悸等，故合用时应测定茶碱类的血药浓度和调整剂量
头孢拉定	苯妥英钠	药效提高	头孢拉定可延缓苯妥英钠在肾小管的排泄
阿酚咖	酒精	不良反应增加	阿酚咖不应与含有酒精的饮料、巴比妥类(如苯巴比妥)、解痉药类(如颠茄)同服，因可造成肝损害
单氯芬那酸	甲氨蝶呤	药效提高，不良反应增加	单氯芬那酸可降低甲氨蝶呤的排泄，增高其血药浓度，甚至可达中毒水平，故单氯芬那酸不应与中或大剂量甲氨蝶呤同用
甲氧氯普胺	地高辛	药效降低	与西咪替丁、慢溶型剂型地高辛同用，后者的胃肠道吸收减少，如间隔2小时服用可以减少这种影响；甲氧氯普胺还可增加地高辛的胆汁排出，从而改变其血浓度；
复方地巴唑氢氯噻嗪	抗真菌药	药效提高，不良反应增加	复方地巴唑氢氯噻嗪与抗真菌药酮康唑、伊曲康唑合用，可提高复方地巴唑氢氯噻嗪疗效并增加其毒性
愈创木酚磺酸钾	溴苯胺	药效提高	溴苯胺、胍乙啶等降压药与愈创木酚磺酸钾同用时，前者的降压，效应可能增强，肾上腺素与愈创木酚磺酸钾同用时，肾上腺素的a作用被阻断，而使β作用占优势
单硝酸异山梨酯Ⅲ	西地那非	药效提高，不良反应增加	和治疗勃起功能障碍的5型磷酸二酯酶抑制剂（如西地那非）合用会增加单硝酸异山梨酯Ⅲ的降压作用，可能引起致命的心血管并发症因此使用单硝酸异山梨酯Ⅲ时不能使用5型磷酸二酯酶抑制剂（如西地那非）
美托洛尔	利福平	药效降低	利福平：利福平可促进美托洛尔的代谢，导致后者的血药浓度降低
利多卡因	苯巴比妥	药效提高，不良反应增加	与西咪替丁以及β受体阻断剂如，普萘洛尔、美托洛尔、纳多洛尔合用，利多卡因经肝脏代谢受抑制，利多卡因血浓度增加，可发生心脏和神经系统不良反应，应调整利多卡因剂量，并应心电图监护及监测利多卡因血药浓度；(2)巴比妥类药物可促进利多卡因代谢，两药合用可引起心动过缓，窦性停搏；(3)与普鲁卡因胺合用，可产生一过性谵妄及幻觉，但不影响利多卡因血药浓度；(4)异丙基肾上腺素因增加肝血流量，可使利多卡因的总清除率升高；去甲肾上腺素因减少肝血流量，可使利多卡因总清除率下降；(5)与下列药品有配伍禁忌：苯巴比妥，硫喷妥钠，硝普钠，甘露醇，两性霉素B，氨苄西林，磺胺嘧啶
洛芬葡锌那敏片	甲氨蝶呤	药效提高，不良反应增加	芬葡锌那敏片与地高辛、甲氨蝶呤、口服降糖药物同用时，能使这些药物血药浓度增高，不宜同用
右旋糖酐铁分散片	左旋多巴	药效降低	右旋糖酐铁分散片可减少左旋多巴、卡比多巴、甲基多巴及喹诺酮类药物的吸收
注射用细辛脑	巴比妥类	药效提高	注射用细辛脑能增强巴比妥类催眠作用
甘氨酸茶碱钠胶囊	维拉帕米	药效提高，不良反应增加	地尔硫卓、维拉帕米可干扰茶碱在肝内的代谢，与甘氨酸茶碱钠胶囊合用，增加甘氨酸茶碱钠胶囊血药浓度和毒性
复方葡萄糖酸钙口服溶液	四环素类	药效降低	复方葡萄糖酸钙口服溶液与苯妥英钠及四环素类同用，二者吸收减少
盐酸二甲双胍缓释胶囊	钙离子通道阻滞剂	药效降低	其它：会导致高血糖的药物与盐酸二甲双胍缓释胶囊合用时，如皮质类固醇、甲状腺素、雌激素、口服避孕药、尼古丁酸、钙离子通道阻滞剂、苯巴比妥类等，可能会使血糖控制失调，应密切监测血糖情况，停止上述药物时，也应密切监测低血糖情况
酮康唑	利福布丁	药效降低	酶诱导药物，如利福平、利福布丁、卡马西平、异烟肼、奈韦拉平和苯妥英，会明显降低酮康唑的生物利用度而降低疗效
复方硫酸亚铁叶酸片	碳酸氢钠	药效降低	复方硫酸亚铁叶酸片与制酸药如碳酸氢钠、四环素类药物、磷酸盐类及含鞣酸的药物或饮料同用，易产生沉淀而影响吸收
洛伐他汀	吉非罗齐	不良反应增加	洛伐他汀与免疫抑制剂如环孢素、阿奇霉素、克拉霉素、红霉素、达那唑、伊曲康唑、吉非罗齐、烟酸等合用可增加肌溶解和急性肾功能衰竭发生的危险
索磷布韦	奥卡西平	药效降低	中度P-gp诱导剂或中度CYP诱导剂类药品（如奥卡西平、莫达非尼或依非韦伦）可能会降低索磷布韦或维帕他韦的血浆浓度，从而导致Epclusa的疗效降低
西拉普利	降压药	药效提高	但当西拉普利与其他降压药物合用时可能会引起相加作用
塞瑞替尼胶囊	伊曲康唑	药效提高	如果同时使用强效CYP3A抑制剂（包括但不限于利托那韦、沙奎那韦、泰利霉素、酮康唑、伊曲康唑、伏立康唑、泊沙康唑、奈法唑酮）无法避免，则应将塞瑞替尼胶囊的剂量减少约三分之一，并近似为150mg剂量规格的倍数
对乙酰氨基酚	巴比妥类	不良反应增加	应用巴比妥类(如苯巴比妥)或解痉药(如颠茄)的患者，长期应用对乙酰氨基酚可致肝损害
氢氯噻嗪	抗真菌药	药效提高，不良反应增加	氢氯噻嗪与抗真菌药酮康唑、伊曲康唑合用，可提高氢氯噻嗪疗效并增加其毒性
异烟肼	酮康唑	药效降低	研究表明，当服用异烟肼与利福平5个月后，酮康唑的AUC降低了88%
双氢麦角毒碱	酮康唑	药效提高，不良反应增加	与细胞色素P450抑制剂如大环内酯类抗生素（如红霉素、克林霉素、三乙酰竹桃霉素、螺旋霉素、交沙霉素），吡咯抗真菌剂（如酮康唑、伊曲康唑）、蛋白酶抑制剂（如力托那韦、茚地那韦）或甲腈咪胍联合用药时可增加双氢麦角毒碱的药物浓度，从而导致外周血管收缩，所以应避免使用
羟考酮	红霉素	药效提高，不良反应增加	可能抑制羟考酮的代谢的其他药物包括：甲氰咪胍，酮康唑和红霉素等细胞色素P450-3A酶抑制剂
丁丙诺啡	卡马西平	药效降低	丁丙诺啡透皮贴剂与酶诱导剂(如，苯巴比妥、卡马西平、苯妥英、利福平)联合使用后，可能会导致清除率升高，继而降低药物的疗效
丙戊酸	劳拉西泮	药效降低	在健康受试者中的研究结果显示，丙戊酸盐和劳拉西泮同时服用时可使劳拉西泮的血药浓度最高减低40%
单硝酸异山梨酯Ⅰ	西地那非	药效提高，不良反应增加	和治疗勃起机能障碍的西地那非合用会增加单硝酸异山梨酯Ⅰ的降压作用，可能引起致命的心血管并发症，因此使用单硝酸异山梨酯Ⅰ时不能使用西地那非
瑞舒伐他汀	HMG-CoA还原酶抑制剂	不良反应增加	维生素K拮抗剂：同其它HMG-CoA还原酶抑制剂一样，对同时使用维生素K拮抗剂（如：华法林）的患者，开始使用瑞舒伐他汀或逐渐增加瑞舒伐他汀剂量可能导致INR升高
利福平	β-阻滞剂	药效降低	据报道利福平可加快下列药物的代谢：抗惊厥药(如苯妥英)，抗心律失常药(如双异丙吡按、美西律、奎尼丁、妥卡尼)，口服抗凝血药，抗真菌药(如氟康唑、伊曲康唑、酮康唑等)，巴比土酸盐，β-阻滞剂，钙离子阻滞剂(如硫氮卓酮、硝苯吡啶、维拉帕米等)，氯霉素、克拉霉素、皮质类固醇、环孢霉素、洋地黄甙类、氯贝特、激素类避孕药，氨苯砜、安定、强力霉素、氟喹诺酮类(如环丙沙星)、氟哌啶醇、口服降糖药(磺酰脲)，左旋甲状腺素、美沙酮、麻醉性镇痛药，去甲替林、孕激素、奎林、茶碱、他克莫司、三环类抗抑郁药(阿米替林、去甲替林)和叠氮胸苷
美沙酮	利福平	药效降低	妥英钠和利福平等能促使肝细胞微粒体酶的活动增强，因而美沙酮在体内的降解代谢加快，用量应相应增加
奎宁	碳酸氢钠	药效提高，不良反应增加	液碱化剂如碳酸氢钠等，可增加肾小管对奎宁的重吸收，导致奎宁血药浓度与毒性的增加；
哌拉西林	青霉素	药效提高	与其他青霉素类相似，特治星®与丙磺舒合并应用可使哌拉西林和他唑巴坦的半衰期延长（哌拉西林的半衰期延长21%，他唑巴坦的半衰期延长71%）、肾脏清除率降低
琥珀胆碱	奎尼丁	药效提高	与下列药物合用也须谨慎，如：吩噻嗪类、普鲁卡因胺、奎尼丁、卡那霉素、多粘菌素B、新霉素等有去极化型肌松作用，能增强琥珀胆碱作用
精氨酸布洛芬	双香豆素	药效提高，不良反应增加	精氨酸布洛芬与肝素、双香豆素等抗凝药同用时，可导致凝血酶原时间延长，增加出血倾向
非诺贝特	呋塞米	药效提高	非诺贝特与其他高蛋白结合率的药物合用时，可使它们的游离型增加，药效增强，如甲苯磺丁脲及其它磺脲类降糖药、苯妥英、呋塞米等，在降血脂治疗期间服用上述药物，则应调整降糖药及其它药的剂量
甲氧苄啶	利福平	药效降低	甲氧苄啶利福平合用，可增加TMP清除，血浆半衰期缩短
环丙沙星	茶碱类	药效提高，不良反应增加	环丙沙星与茶碱类合用时可能由于与细胞色素P450结合部位的竟争性抑制，导致茶碱类的肝清除明显减少，血消除半衰期（t1/2β）延长，血药浓度升高，出现茶碱中毒症状，如恶心、呕吐、震颤、不安、激动、抽搐、心悸等，故合用时应测定茶碱类血药浓度和调整剂量
苯唑西林	苯巴比妥	药效降低，不良反应增加	苯唑西林与氨基糖苷类、去甲肾上腺素、间羟胺、苯巴比妥、维生素B族、维生素C等药物存在配伍禁忌，不宜同瓶滴注
精氨酸布洛芬	肝素	药效提高，不良反应增加	精氨酸布洛芬与肝素、双香豆素等抗凝药同用时，可导致凝血酶原时间延长，增加出血倾向
去乙酰毛花苷	奎尼丁	药效提高，不良反应增加	奎尼丁同用，可使去乙酰毛花苷血药浓度提高约一倍，提高程度与奎尼丁用量相关，甚至可达到中毒浓度，即使停用地高辛，其血药浓度仍继续上升，这是奎尼丁从组织结合处置换出地高辛，减少其分布容积之故
利福平	阿米替林	药效降低	据报道利福平可加快下列药物的代谢：抗惊厥药(如苯妥英)，抗心律失常药(如双异丙吡按、美西律、奎尼丁、妥卡尼)，口服抗凝血药，抗真菌药(如氟康唑、伊曲康唑、酮康唑等)，巴比土酸盐，β-阻滞剂，钙离子阻滞剂(如硫氮卓酮、硝苯吡啶、维拉帕米等)，氯霉素、克拉霉素、皮质类固醇、环孢霉素、洋地黄甙类、氯贝特、激素类避孕药，氨苯砜、安定、强力霉素、氟喹诺酮类(如环丙沙星)、氟哌啶醇、口服降糖药(磺酰脲)，左旋甲状腺素、美沙酮、麻醉性镇痛药，去甲替林、孕激素、奎林、茶碱、他克莫司、三环类抗抑郁药(阿米替林、去甲替林)和叠氮胸苷
对乙酰氨基酚	酒精	不良反应增加	对乙酰氨基酚不应与含有酒精的饮料、巴比妥类（如苯巴比妥）、解痉药（如颠茄）同服，因可造成肝脏损害
枸橼酸铋钾	齐多夫定	药效降低	HIV感染的成年人同时口服枸橼酸铋钾和齐多夫定时，枸橼酸铋钾会干扰后者的吸收，使其稳态血浓度下降，应错开服用时间
艾司唑仑	卡马西平	药效降低	艾司唑仑与卡马西平合用时，由于肝微粒体酶的诱导可使两者的血药浓度下降，清除半衰期缩短
单硝酸异山梨酯Ⅳ	西地那非	药效提高	同时应用一氧化二氮供体，如单硝酸异山梨酯Ⅳ中的活性成分和西地那非,抗高血压作用可明显加强
盐酸普萘洛尔缓释片	抗高血压药物	不良反应增加	与抗高血压药物相互作用：盐酸普萘洛尔缓释片与利血平合用，可导致体位性低血压、心动过缓、头晕、晕厥
阿昔洛韦	丙磺舒	药效提高	与丙磺舒一起使用时，会竞争性抑制有机酸分泌，使阿昔洛韦排泄减退，平均半衰期延长和药时曲线下面积增加，体内药物积蓄
酮洛芬Ⅱ	抗凝药	药效提高，不良反应增加	酮洛芬Ⅱ与肝素、双香豆素等抗凝药同时使用，可导致凝血酶原时间延长，增加出血倾向
肌苷氯化钠注射液	盐酸万古霉素	药效降低，不良反应增加	肌苷氯化钠注射液禁与下列注射液配伍：乳清酸、氯霉素、双嘧达莫、盐酸山梗菜碱、硫酸阿托品、氢溴酸东莨菪碱、盐酸氯丙嗪、盐酸异丙嗪、马来酸麦角新碱、盐酸普鲁卡因、硫喷妥钠、苯妥英钠、氯氮卓、盐酸去甲肾上腺素、盐酸丁卡因、利血平、硝普钠、降压嗪、呋噻米、利尿酸钠、促皮质素、维生素B12、盐酸苯海拉明、马来酸氯苯那敏、细胞色素C、盐酸万古霉素、盐酸四环素、二盐酸奎宁、盐酸阿糖胞苷、硫酸长春新碱以及所有菌苗和疫苗
阿莫西林	抗生素	药效提高	丙磺舒降低阿莫西林从肾小管中分泌，与阿莫西林合用时会升高阿莫西林的血药浓度，建议不与利尿酸药合用；别嘌呤醇(治痛风药)和阿莫西林合用会增加病人皮疹的发病率，尚未明确阿莫西林引发皮疹是由于因病人体内的别嘌呤醇还是因血尿酸升高引起的，尚未有阿莫西林与别嘌呤醇合用的资料；与其他广谱抗生素相似，阿莫西林可能降低避孕药的药效
硫酸核糖霉素注射液	氨基糖苷类	不良反应增加	硫酸核糖霉素注射液与其它氨基糖苷类同用或先后连续局部或全身应用，可增加耳毒性、肾毒性以及神经肌肉阻滞作用的可能性
布洛芬	华法林	药效提高，不良反应增加	布洛芬与肝素、双香豆素（如华法林）等抗凝药同用时，可导致凝血酶原时间延长，增加出血倾向
利托那韦片	抗HIV	药效提高	一些药品（或食物）可能会与利托那韦片互相干扰，包括：①与齐多夫定或去羟基苷合用时，抗HIV-1作用可能相加
阿莫西林	别嘌呤醇	不良反应增加	虽然尚无阿莫西林与别嘌呤醇合用的资料，但阿莫西林与别嘌呤酵合用可增加过敏性皮肤反应的可能性
复方炔诺酮片	降血糖药	药效降低	复方炔诺酮片可减弱抗高血压药、抗凝血药以及降血糖药的疗效
卡维地洛	利福平	药效降低	卡维地洛用于接受利福平等混合功能氧化酶诱导剂的病人时，卡维地洛的血药浓度可能会降低
胺碘酮	氟卡尼	药效提高	胺碘酮可增高血浆中奎尼丁、普鲁卡因胺、氟卡尼及苯妥英的浓度
头孢哌酮	氨茶碱	药效降低，不良反应增加	头孢哌酮与安太乐、普鲁卡因胺、氨茶碱、丙氯拉嗪、细胞色素C、镇痛新、抑肽酶混合后1/2小时发生外观变化
利多卡因Ⅰ	氨苄西林	药效提高，不良反应增加	与西咪替丁以及β受体阻断剂如，普萘洛尔、美托洛尔、纳多洛尔合用，利多卡因经肝脏代谢受抑制，利多卡因血浓度增加，可发生心脏和神经系统不良反应，应调整利多卡因剂量，并应心电图监护及监测利多卡因血药浓度；(2)巴比妥类药物可促进利多卡因代谢，两药合用可引起心动过缓，窦性停搏；(3)与普鲁卡因胺合用，可产生一过性谵妄及幻觉，但不影响利多卡因Ⅰ血药浓度；(4)异丙基肾上腺素因增加肝血流量，可使利多卡因Ⅰ的总清除率升高；去甲肾上腺素因减少肝血流量，可使利多卡因Ⅰ总清除率下降；(5)与下列药品有配伍禁忌：苯巴比妥，硫喷妥钠，硝普钠，甘露醇，两性霉素B，氨苄西林，磺胺嘧啶
塞克硝唑分散片	华法令	药效降低	塞克硝唑分散片对华法令的抗凝作用有很强的抑制，故有血象异常既往史的患者不宜服用
氨氯地平	β-阻滞剂	药效提高，不良反应增加	8、β-阻滞剂：与氨氯地平合用耐受性良好，但可引起过度低血压，罕见加重心力衰竭
维D钙咀嚼片	苯妥英钠	药效降低	维D钙咀嚼片与苯妥英钠类及四环素类同用，二者吸收减低
硝苯地平	细胞色素P4503A4	药效提高	另外，此类药物在体外可抑制细胞色素P4503A4介导的硝苯地平的代谢
氢氯噻嗪	去甲肾上腺素	药效降低	升压胺类药物：氢氯噻嗪可减弱升压胺类药物（如去甲肾上腺素）的作用
胰岛素	酒精	药效提高，不良反应增加	中等量至大量的酒精可增强胰岛素引起的低血糖的作用，可引起严重、持续的低血糖，在空腹或肝糖原贮备较少的情况下更易发生
比索洛尔	丙吡胺	药效提高	I类抗心律失常药物（如丙吡胺、奎尼丁）：可能增加比索洛尔对房室传导和心脏收缩力的抑制作用
依非韦伦	西罗莫司	药效降低	由CYP3A4代谢的免疫抑制剂（比如环孢霉素A、他克莫司或西罗莫司）与依非韦伦同时服用时，由于CYP3A4的减少可能发生免疫抑制剂暴露量的减少
枸磺新啶	激素类避孕药	药效降低	雌激素类避孕药与枸磺新啶长期合用可降低避孕效果
奎宁	硝苯地平	药效提高	硝苯地平（硝苯啶）合用，游离的奎宁浓度增加
格列齐特	丙磺舒	药效提高	抑制格列齐特由尿中排泄，如治疗痛风的丙磺舒、别嘌呤等；
吡哌酸	丙磺舒	药效提高	丙磺舒可抑制由创面吸收后的吡哌酸的肾小管分泌，合用时后者血药浓度升高，半衰期(t1/2)延长
米诺环素	卡马西平	药效降低	由于巴比妥类、苯妥英或卡马西平可诱导微粒体酶的活性致使米诺环素血药浓度降低，故合用时须调整米诺环素的剂量
格列美脲胶囊	拟交感神经药	药效降低	氯丙嗪，拟交感神经药，皮质激素类，甲状腺激素，口服避孕药和烟酸制剂等可降低格列美脲胶囊降血糖作用
赖诺普利胶囊	利尿剂	药效提高	接受赖诺普利胶囊治疗的患者加用利尿剂，抗高血压作用通常增强
对乙酰氨基酚干混悬剂	氯霉素	不良反应增加	对乙酰氨基酚干混悬剂与氯霉素同服，可增强后者的毒性
西索米星	头孢噻吩	药效降低，不良反应增加	西索米星不宜与两性霉素B、头孢噻吩、呋喃妥英钠、磺胺嘧啶钠和四环素等(以上均为注射液)联合应用，因可发生配伍禁忌
盐酸罗匹尼罗缓释片	甲氧氯普胺	药效降低	由于罗匹尼罗是一种多巴胺激动剂，多巴胺拮抗剂如精神安定类药（酚噻嗪类、苯丁酮类和硫杂蒽类）或甲氧氯普胺可降低盐酸罗匹尼罗缓释片的疗效
右旋糖酐铁分散片	甲基多巴	药效降低	右旋糖酐铁分散片可减少左旋多巴、卡比多巴、甲基多巴及喹诺酮类药物的吸收
布洛芬	呋喃苯胺酸	药效降低	布洛芬与呋塞米（呋喃苯胺酸）同用时，后者的排钠和降压作用减弱；与抗高血压药同用时也降低后者的降压效果
替格瑞洛	辛伐他汀	不良反应增加	替格瑞洛与剂量超过40mg/日的辛伐他汀合并给药可引发辛伐他汀不良反应，应与潜在获益之间进行权衡
舒巴坦	保泰松	药效提高，不良反应增加	丙磺舒、阿司匹林、吲哚美辛、保泰松、磺胺药可减少舒巴坦自肾脏排泄，因此与舒巴坦合用时使其血药浓度增高，排泄时间延长，毒性也可能增加
洛芬葡锌那敏	抗高血压药	药效降低	芬葡锌那敏与呋塞米(呋喃苯胺酸)同用时，后者的排钠和降压作用减弱;与抗高血压药同用时也降低后者的降压效果
维拉帕米	长春碱	药效降低	环磷酰胺、长春新碱、甲基苄肼、强的松、长春碱酰胺、阿霉素、顺铂等细胞毒性药物减少维拉帕米的吸收
磷酸钠	苯妥因	药效降低	与巴比妥类、苯妥因、利福平同服，磷酸钠代谢促进作用减弱
利多卡因	纳多洛尔	药效提高，不良反应增加	与西咪替丁以及与受体阻滞剂如，普萘洛尔、美托洛尔、纳多洛尔合用，利多卡因经肝脏代谢受抑制，利多卡因血浓度增加，可发生心脏和神经系统不良反应
非洛地平	伊曲康唑	药效提高	合用伊曲康唑可使非洛地平Cmax增加6倍，AUC增加6倍
单硝酸异山梨酯Ⅳ	双氢麦角胺	药效提高	同时服用单硝酸异山梨酯Ⅳ和双氢麦角胺，会增加血中双氢麦角胺的水平和它的升压作用
肝素	头孢孟多	药效降低，不良反应增加	下列药物与肝素有配伍禁忌：卡那霉素、阿米卡星、柔红霉素、乳糖酸红霉素、硫酸庆大霉素、氢化考的松琥珀酸钠、多粘菌素B、阿霉素、妥布霉素、万古霉素、头孢孟多、头孢氧哌唑、头孢噻吩钠、氯喹丙嗪、异丙嗪、麻醉性镇痛药
氢氯噻嗪	维生素D	药效提高	维生素D：联合使用噻嗪类利尿剂（包括氢氯噻嗪）与维生素D或钙盐可引起血钙升高
安非他酮	苯巴比妥	药效降低	如有些药物可以诱导安非他酮的代谢（卡马西平、苯巴比妥、苯妥英），有些药物可以抑制安非他酮的代谢（如西米替丁）
酚氨咖敏	抗凝药	药效提高	大量或长期应用酚氨咖敏，可减少凝血因子在肝内的合成，有增强抗凝药的作用
哌柏西利	阿芬太尼	药效提高	治疗指数狭窄的敏感CYP3A4底物（如，阿芬太尼、环孢素、双氢麦角胺、麦角胺、依维莫司、芬太尼、匹莫齐特、奎尼丁、西罗莫司和他克莫司）与哌柏西利同时使用时可能需要降低剂量，因为哌柏西利可增加它们的暴露量
盐酸二甲双胍缓释胶囊	雌激素	药效降低	其它：会导致高血糖的药物与盐酸二甲双胍缓释胶囊合用时，如皮质类固醇、甲状腺素、雌激素、口服避孕药、尼古丁酸、钙离子通道阻滞剂、苯巴比妥类等，可能会使血糖控制失调，应密切监测血糖情况，停止上述药物时，也应密切监测低血糖情况
氯喹	青霉胺	不良反应增加	氯喹对神经肌肉接头有直接抑制作用，链霉素可加重此不良反应.4.洋地黄化后应用氯喹易引起心脏传导阻滞.5.氯喹与肝素或青霉胺合用，可增加出血机会
仑氨西林	丙磺舒	药效提高	与丙磺舒合用会延长仑氨西林的半衰期
单硝酸异山梨酯缓释胶囊(IV)	钙通道阻滞剂	药效提高	同时服用具降血压作用的药物，如β-受体阻滞剂、钙通道阻滞剂、血管扩张药和/或酒精，精神安定剂，三环类抗抑郁药可增强单硝酸异山梨酯缓释胶囊(IV)的降血压作用
降钙素	锂	药效降低	降钙素与锂合用可能导致血浆中锂浓度下降
己烯雌酚	利福平	药效降低	烯雌酚与卡马西平、苯巴比妥、苯妥英钠、扑米酮、利福平等同时使用，可减低己烯雌酚的效应
缬沙坦	环孢菌素	药效提高	因此，在诺欣妥®合用OATP1B1、OATP1B3、OAT3抑制剂（例如利福平，环孢菌素）或MRP2抑制剂（例如利托那韦）时可能增加LBQ657或缬沙坦的全身暴露量
乙水杨胺	碳酸氢钠	药效降低	抗酸药如碳酸氢钠等可增加乙水杨胺自尿中的排泄，使血药浓度下降，不宜同用
氯丙嗪	抗胆碱药	药效提高	氯丙嗪与抗胆碱药合用，效应彼此加强
达诺瑞韦钠片	苯妥英	药效提高	CYP3A抑制剂（如酮康唑）或诱导剂（如利福平、利福布汀、苯巴比妥、苯妥英、卡马西平）会改变达诺瑞韦钠片的血药浓度
阿莫西林克拉维酸钾分散片(14:1)	四环素类	药效降低	氯霉素、红霉素、四环素类等抗生素和磺胺药等抑菌药可干扰阿莫西林克拉维酸钾分散片(14:1)的杀菌活性，因此不宜与阿莫西林克拉维酸钾分散片(14:1)合用，尤其在治疗脑膜炎或急需杀菌药的严重感染时
利福平	抗肿瘤药	药效降低，不良反应增加	利福平可诱导肝微粒体酶，增加抗肿瘤药达卡巴嗪(dacarbazine)、环磷酰胺的代谢，形成烷化代谢物，促使白细胞减低，因此需调整剂量
维生素B12	维生素C	药效降低	体外实验发现，维生素C可破坏维生素B12同时给药或长期大量摄人维生素C时，可使维生素B12血浓度降低
西咪替丁咀嚼片	茶碱	药效提高，不良反应增加	西咪替丁咀嚼片与硝西泮（硝基安定）、地西泮（安定）、茶碱、普萘洛尔（心得安）、苯妥英钠、阿司匹林等同用时，均可使这些药物的血药浓度升高，作用增强，出现不良反应，甚至是毒性反应，故西咪替丁咀嚼片不宜与这些药物同用
牡蛎碳酸钙泡腾片	苯妥英钠	药效降低	牡蛎碳酸钙泡腾片与苯妥英钠及四环素类同用，二者吸收减少
磷酸钠	巴比妥类	药效降低	与巴比妥类、苯妥因、利福平同服，磷酸钠代谢促进作用减弱
硝酸异山梨酯	双氢麦角胺	药效提高	硝酸异山梨酯注射液与双氢麦角胺联合用药，会增加血中双氢麦角胺的水平和它的升压作用
多奈哌齐	酮康唑	药效提高	在对健康志愿者进行的研究中，酮康唑增加多奈哌齐的平均浓度大约30%
环孢素软胶囊	红霉素	药效提高	提高环孢素软胶囊血浆或全血浓度的药品有：酮康唑、氟康唑、伊曲康唑、红霉素、交沙霉素、克拉霉素等大环内酯类抗生素，强力霉素、口服避孕药、普罗帕酮以及地尔硫卓、尼卡地平、维拉帕米等钙拮抗剂，氟伏沙明、乙酰唑胺、甲氧氯普胺、达那唑、甲泼尼龙（高剂量）、别嘌醇、胺碘酮、胆酸及其衍生物、蛋白酶抑制剂
辛伐他汀	环孢素	不良反应增加	辛伐他汀与免疫抑制剂如环孢素、红霉素、吉非罗齐、烟酸等合用可增加肌溶解和急性肾功能衰竭发生的危险
利托那韦口服溶液	阿普唑仑	不良反应增加	阿普唑仑、安非他酮、胺碘酮、阿咪唑、苄替地尔、西沙必利、氯拉折帕、氯氮平、右丙氧芬、地西泮、二氢麦角胺、恩卡肢、舒乐安定、麦角胺、氟卡胺、氟西泮、咪达唑仑、哌替啶、匹莫齐特、吡罗昔康、普罗帕酮、奎尼丁、利福布丁、特非那定、三唑仑和左吡登禁止用于利托那韦口服溶液治疗的病人，因为它们可能与利托那韦口服溶液发生相互作用，产生严重并发症的危险
肝素	头孢噻吩	药效降低，不良反应增加	下列药物与肝素有配伍禁忌：卡那霉素、阿米卡星、柔红霉素、乳糖酸红霉素、硫酸庆大霉素、氢化考的松琥珀酸钠、多粘菌素B、阿霉素、妥布霉素、万古霉素、头孢孟多、头孢氧哌唑、头孢噻吩钠、氯喹丙嗪、异丙嗪、麻醉性镇痛药
依诺沙星	丙磺舒	药效提高，不良反应增加	丙磺舒可减少依诺沙星自肾小管分泌约50%，合用时可因依诺沙星血浓度增高而产生毒性
硝苯地平	细胞色素P4503A4	药效降低	苯妥英:可诱导细胞色素P4503A4系统，与苯妥英合用时，硝苯地平的生物利用度降低从而导致疗效下降
盐酸二甲双胍缓释胶囊	尼古丁	药效降低	其它：会导致高血糖的药物与盐酸二甲双胍缓释胶囊合用时，如皮质类固醇、甲状腺素、雌激素、口服避孕药、尼古丁酸、钙离子通道阻滞剂、苯巴比妥类等，可能会使血糖控制失调，应密切监测血糖情况，停止上述药物时，也应密切监测低血糖情况
注射用哌拉西林钠/他唑巴坦钠	万古霉素	不良反应增加	研究发现，与单独使用万古霉素相比，注射用哌拉西林钠/他唑巴坦钠与万古霉素联合使用的患者中急性肾损伤发生率上升(见【注意事项】)
氯化钠	丙磺舒	药效提高，不良反应增加	丙磺舒可延迟氯化钠的排泄，使平均曲线下面积（AUC）增大63%，平均达峰时间（tmax延长50%，平均峰浓度（Cmax）增高4%；故合用时可因氯化钠血浓度增高而产生毒性
奎宁	硝苯地平	药效提高，不良反应增加	酸药及含铝制剂能延缓或减少奎宁的吸收；②抗凝药与奎宁合用后，抗凝作用可增强；③肌肉松弛药如琥珀胆碱、筒箭毒碱等与奎宁合同，可能会引起呼吸抑制；④奎尼丁与奎宁合用，金鸡纳反应可增加；⑤尿液碱化剂如碳酸氢钠等，可增加肾小管对奎宁的重吸收，导致奎宁血药浓度与毒性的增加；⑥与维生素K合用可增加奎宁的吸收；⑦与布克利嗪、赛克利嗪、美克利嗪、吩噻嗪类、噻吨类、曲美苄胺（trimethofenzamide）、氨基苷类抗生素合用可导致耳鸣、眩晕；⑧与硝苯地平（硝苯啶）合用，游离的奎宁浓度增加
西索米星	四环素	药效降低，不良反应增加	西索米星不宜与两性霉素B、头孢噻吩钠、呋喃妥因钠，磺胺嘧啶钠和四环素（以上均为注射液）联合应用，因可发生配伍禁忌
环丙沙星	喹诺酮类	药效提高	一些喹诺酮类（包括环丙沙星）也可影响咖啡因的代谢，从而降低咖啡因的清除率，延长其血清半衰期
异丙东莨菪碱	β-肾上腺素能兴奋剂	药效提高	使用β-肾上腺素能兴奋剂或黄嘌呤类制剂(如茶碱)可加强异丙东莨菪碱的作用
缬沙坦	环孢素	药效提高	合并使用摄取性转运蛋白抑制剂（例如，利福平，环孢素）或者外排性转运蛋白抑制剂（例如，利托那韦）可能会增加缬沙坦的全身暴露量
托西溴苄铵注射液	奎尼丁	药效降低	奎尼丁或普鲁卡因胺与托西溴苄铵注射液合用时有相互拮抗作用，影响各自疗效，故不宜与类似奎尼丁样抗心律失常作用的药合用
双氯芬酸钠缓释胶囊	甲氨喋呤	药效提高，不良反应增加	双氯芬酸钠缓释胶囊可降低甲氯喋岭的排泄，增高其血浓度，甚至可达中毒水平，故双氯芬酸钠缓释胶囊不应与中或大剂量甲氨喋呤同用
孟鲁司特	吉非贝齐	药效提高	一项涉及孟鲁司特和吉非贝齐(CYP2c8和2C9的抑制剂)药物间相互作用的临床研究证明,吉非贝齐能使孟鲁司特的全身暴露水平增加4.4倍
奥硝唑	雷尼替丁	药效降低，不良反应增加	巴比妥类药、雷尼替丁和西咪替丁等药物可使奥硝唑加速消除而降效并可影响凝血，因此应禁忌合用
头孢克洛干糖浆	布美他尼	不良反应增加	呋塞米、依他尼酸、布美他尼等强利尿药，卡氮芥、链佐星等抗肿瘤药及氨基糖苷类抗生素等肾毒性药物与头孢克洛干糖浆合用有增加肾毒性的可能
利福平异烟肼胶囊	乙硫异烟胺	不良反应增加	利福平异烟肼胶囊与乙硫异烟胺、吡嗪酰胺或其他抗结核药合用可加重其不良反应
注射用盐酸多沙普仑	咖啡因	不良反应增加	注射用盐酸多沙普仑与咖啡因、哌醋甲酯、匹莫林、肾上腺素受体激动药等合用，可能出现紧张、激动、失眠甚至惊厥或心律失常
注射用哌拉西林钠/他唑巴坦钠	氨基糖苷类药物	药效降低	由于哌拉西林可使氨基糖苷类药物在体外失活，因此建议注射用哌拉西林钠/他唑巴坦钠与氨基糖苷类药物分开给药
多司马酯	抗生素	药效降低	喹诺酮类抗生素如环丙沙星，诺氟沙星等，应该在服用多司马酯2至6个小时前或4个小时后服用，因多司马酯可令其形成不可溶的化合物
孟鲁司特	苯巴比妥	药效降低	由于孟鲁司特通过CYP3A4、2C8和2C9代谢，因此孟鲁司特应谨慎与CYP3A4、2C8和2C9诱导剂（如苯妥英钠、苯巴比妥、利福平）同时服用，特别是儿童
依巴斯汀	红霉素	药效提高，不良反应增加	研究表明当依巴斯汀与酮康唑或红霉素（已知这两种药物均可延长QT间期）联合应用时，有药物代谢动力学及药效动力学方面的相互作用，使依巴斯汀的血药浓度增高—尽管较以上两种药物单独使用仅使QT间期延长10ms，并且依巴斯汀应慎用于同时服用酮康唑或红霉素的患者
哌柏西利	依维莫司	药效提高	治疗指数狭窄的敏感CYP3A4底物（如，阿芬太尼、环孢素、双氢麦角胺、麦角胺、依维莫司、芬太尼、匹莫齐特、奎尼丁、西罗莫司和他克莫司）与哌柏西利同时使用时可能需要降低剂量，因为哌柏西利可增加它们的暴露量
罗格列酮	奎宁	药效提高	虽然这种与阳离子药物（如，阿米洛利、地高辛、吗啡、普鲁卡因酰胺、奎尼丁、奎宁、雷尼替丁、氨苯喋啶、甲氧苄啶和万古霉素）的相互作用仍然是理论上的（西咪替丁除外），但使用经近端肾小管分泌系统排泄的阳离子药物的患者，用罗格列酮治疗时应当密切观察病情，调整罗格列酮和/或干扰药物的剂量
卡马西平	雌激素	药效降低	与含雌激素的避孕药、环孢素、洋地黄类(可能地高辛除外)、雌激素、左旋甲状腺素或奎尼丁合用时，由于卡马西平对肝药酶的诱导，这些药的效应都会降低，用量应作调整，改用仅含孕激素(黄体酮)的口服避孕药
阿立哌唑	酮康唑	药效提高	CYP3A4诱导剂（如卡马西平）将会引起阿立哌唑的清除率升高和血药浓度降低，CYP3A4抑制剂（如酮康唑）或CYP2D抑制剂（如：奎尼丁、氟西汀、帕罗西汀）可以抑制阿立哌唑的消除，使血药浓度升高
维U颠茄铝Ⅰ	丙卡巴肼	不良反应增加	维U颠茄铝Ⅰ与单胺氧化酶(MAO)抑制剂、呋喃唑酮、丙卡巴肼等合用时，颠茄在肝脏的解毒被阻断，因而加强了其抗M胆碱作用的不良反应，另外，此种抑制剂本身也有抗M胆碱作用
氯化钠	抗凝药	药效提高	氯化钠与抗凝药华法林合用时可增强后者的抗凝作用，合用时应严密监测患者的凝血酶原时间
溴丙胺太林	红霉素	药效降低	如红霉素可因在胃内停留过长而受到胃酸分解，降低疗效，对乙酰氨基酚的吸收可被延迟，血浆峰浓度降低；地高辛的血浆浓度可因同用溴丙胺太林而提高
头孢噻肟舒巴坦	美洛西林	药效提高	与阿洛西林或美洛西林等合用，可使头孢噻肟舒巴坦的总清除率降低，如二者合用需适当减低剂量
注射用头孢地秦钠	多粘菌素B	不良反应增加	注射用头孢地秦钠可加强具有潜在肾毒性药物的毒性作用，如与氨基甙类、两性霉素B、环孢素、顺铂、万古霉素、多粘菌素B或粘菌素同时或先后使用时，应密切监测肾功能
精氨酸布洛芬散	地高辛	药效提高，不良反应增加	精氨酸布洛芬散与地高辛、甲氨蝶呤、巴氯酚、口服降血糖药物同用时，能使这些药物的血药浓度增高，不宜同用
头孢孟多	钙	药效降低，不良反应增加	头孢孟多制剂中含有碳酸钠，因而与含有钙或镁的溶液（包括复方氯化钠注射液或复方乳酸钠注射液）有配伍禁忌
维生素E	氢氧化铝	药效降低	大量氢氧化铝可使小肠上段的胆酸沉淀，降低脂溶性维生素E的吸收
萘普生	双香豆素	药效提高，不良反应增加	萘普生可加强肝素及双香豆素的抗凝血作用，使出血时间延长
三维亚铁口服溶液	胰酶	药效降低	三维亚铁口服溶液与西米替丁、去铁胺、二巯丙醇、胰酶、胰脂肪酶等同用，可影响铁的吸收；与铁合用，可影响四环素类药物、喹诺酮类、青霉胺及锌制剂的吸收
单硝酸异山梨酯缓释胶囊	西地那非	药效提高	同时服用一氧化二氮供体，如单硝酸异山梨酯缓释胶囊的活性成分和西地那非（VIAGRA），抗高血压药物可明显加强
复方溴丙胺太林片	奎尼丁	不良反应增加	奎尼丁和复方溴丙胺太林片同用，其类似阿托品样的效应加重
布洛芬	呋喃苯胺酸	药效降低	与呋塞米（呋喃苯胺酸）同用时，后者的排钠和降压作用减弱；布洛芬可降低抗高血压药的降压效果
利多卡因葡萄糖	甘露醇	药效提高，不良反应增加	与西咪替丁以及b受体阻断剂如，普萘洛尔、美托洛尔、纳多洛尔合用，利多卡因经肝脏代谢受抑制，利多卡因血浓度增加，可发生心脏和神经系统不良反应，应调整利多卡因剂量，并应心电图监护及监测利多卡因血药浓度；（2）巴比妥类药物可促进利多卡因代谢，两药合用可引起心动过缓，窦性停搏；（3）与普鲁卡因胺合用，可产生一过性谵妄及幻觉，但不影响利多卡因葡萄糖血药浓度；（4）异丙基肾上腺素因增加肝血流量，可使利多卡因葡萄糖的总清除率升高；去甲肾上腺素因减少肝血流量，可使利多卡因葡萄糖总清除率下降；（5）与下列药品有配伍禁忌：苯巴比妥，硫喷妥钠，硝普钠，甘露醇，两性霉素B，氨苄西林，磺胺嘧啶
左甲状腺素	洋地黄糖苷	药效降低	左甲状腺素可能会降低洋地黄糖苷的治疗作用
地氟烷	泮库溴铵	药效提高	与N2O/阿片类药物的麻醉方案相比，在平衡状态下（在检测前15分钟或更长时间给药），麻醉浓度的地氟烷大约使琥珀胆碱的ED95降低了30%，大约使阿曲库铵和泮库溴铵的ED95降低了50%
复方头孢克洛胶囊	呋塞米	不良反应增加	呋塞米、依他尼酸、布美他尼等强利尿药，卡氮芥、链佐星等抗肿瘤药及氨基糖苷类抗生素等肾毒性药物与复方头孢克洛胶囊合用有增加肾毒性的可能
布比卡因	利多卡因	药效提高，不良反应增加	β-阻断剂能降低肾血流，与布比卡因并用会减慢利多卡因的清除；多卡胺与利多卡因的药理特性相似，与布比卡因并用会增加不良反应的发生，包括中枢神经系统反应如癫痫发作等
对乙酰氨基酚	巴比妥类	不良反应增加	应用巴比妥类（如苯巴比妥）或解痉药（如颠茄）的患者，长期使用对乙酰氨基酚时可致肝脏损害
氟西泮	降压药	药效提高，不良反应增加	氟西泮与抗高血压药或与利尿降压药合用时，可使降压作用增强
氟康唑葡萄糖	环孢素	药效提高，不良反应增加	高剂量氟康唑葡萄糖和环孢素合用时，可使环孢素的血药浓度升高，致毒性反应发生的危险性增加，因此必须在监测环孢素血药浓度并调整剂量的情况下方可谨慎应用
丁丙诺啡	卡马西平	药效降低	如果停用了CYP3A4诱导剂（例如，依法韦仑、苯巴比妥、卡马西平、苯妥英、利福平），则可以考虑减少丁丙诺啡/纳诺酮舌下片的用药剂量，同时监测患者的呼吸抑制体征（参见【药代动力学】）
齐多夫定	长春新碱	不良反应增加	与具有潜在肾毒性或骨髓抑制作用的药物，如全身用喷他咪、氨苯砜、乙胺嘧啶、复方磺胺甲恶唑、两性霉素、氟胞嘧啶、更昔洛韦、干扰素、长春新碱、长春花碱及阿霉素同时应用，特别在急性期治疗时亦可以使齐多夫定产生不良反应的机率增加
克拉霉素	金丝桃素	药效降低	诱导CYP3A的药物（利福平、苯妥英、卡马西平、苯巴比妥和金丝桃素）可诱导克拉霉素的代谢
尼罗替尼	苯巴比妥	药效降低	同时服用CYP3A4诱导剂（如利福平、卡马西平、苯巴比妥、苯妥英和贯叶连翘）可能减少尼罗替尼的暴露
利多卡因Ⅰ	去甲肾上腺素	药效提高，不良反应增加	与西咪替丁以及β受体阻断剂如，普萘洛尔、美托洛尔、纳多洛尔合用，利多卡因经肝脏代谢受抑制，利多卡因血浓度增加，可发生心脏和神经系统不良反应，应调整利多卡因剂量，并应心电图监护及监测利多卡因血药浓度；(2)巴比妥类药物可促进利多卡因代谢，两药合用可引起心动过缓，窦性停搏；(3)与普鲁卡因胺合用，可产生一过性谵妄及幻觉，但不影响利多卡因Ⅰ血药浓度；(4)异丙基肾上腺素因增加肝血流量，可使利多卡因Ⅰ的总清除率升高；去甲肾上腺素因减少肝血流量，可使利多卡因Ⅰ总清除率下降；(5)与下列药品有配伍禁忌：苯巴比妥，硫喷妥钠，硝普钠，甘露醇，两性霉素B，氨苄西林，磺胺嘧啶
利福平	安定	药效降低	利福平与地西泮(安定)合用可增加后者的消除，使其血药浓度减低，故需调整剂量
硫酸氨基葡萄糖胶囊	氯霉素	药效提高	硫酸氨基葡萄糖胶囊可增加四环素类药物在胃肠道的吸收，减少口服青霉素或氯霉素的吸收
氯喹	洋地黄	不良反应增加	氯喹对神经肌肉接头有直接抑制作用，链霉素可加重此不良反应.4.洋地黄化后应用氯喹易引起心脏传导阻滞.5.氯喹与肝素或青霉胺合用，可增加出血机会
西拉普利	血管紧张素转换酶抑制剂	药效降低	和其他血管紧张素转换酶抑制剂一样，与非甾体抗炎药物合用时，可能会降低西拉普利的降压作用
齐拉西酮	卡马西平	药效降低	卡马西平剂量越高，齐拉西酮的AUC降得越多
单硝酸异山梨酯缓释片	三环抗抑郁药	药效提高，不良反应增加	同时服用扩张血管药，抗高血压药，β-阻断剂，钙拮抗剂，安定药，三环抗抑郁药或酒精，能增加单硝酸异山梨酯缓释片的高血压效应
氟西泮	卡马西平	药效降低	氟西泮与卡马西平合用时，由于肝微粒体酶的诱导可使两者的血药浓度下降，清除半衰期缩短
复方维U颠茄铋镁片	甲氧氯普胺	药效降低	复方维U颠茄铋镁片可减弱甲氧氯普胺、多潘立酮的作用
丙戊酸	尼莫地平	药效提高	丙戊酸与尼莫地平的联合治疗可能增加50%的尼莫地平的血浆浓度
阿立哌唑	卡马西平	药效降低	CYP3A4和CYP2D6参与阿立哌唑的代谢，CYP3A4诱导剂（如卡马西平）将会引起阿立哌唑的清除率升高和血药浓度降低
氢化可的松	氨基糖苷类	药效降低	氢化可的松与巴比妥类、抗癫痫药、氨基糖苷类、利福平合用可导致氢化可的松效应降低
哌拉西林	妥布霉素	药效降低	当哌拉西林与妥布霉素同用时，由于哌拉西林他唑巴坦可能使妥布霉素失活，使妥布霉素的药时曲线下面积、肾脏清除率及尿中排泄将分别下降11%、32%和38%
呱西替柳	抗酸药	药效降低	抗酸药如碳酸氢钠等可加速呱西替柳自尿中的排泄，不宜同用
洛匹那韦/利托那韦口服溶液	氟卡胺	不良反应增加	阿普唑仑、安非他酮、胺碘酮、阿咪唑、苄替地尔、西沙必利、氯拉折帕、氯氮平、右丙氧芬、地西泮、二氢麦角胺、恩卡肢、舒乐安定、麦角胺、氟卡胺、氟西泮、咪达唑仑、哌替啶、匹莫齐特、吡罗昔康、普罗帕酮、奎尼丁、利福布丁、特非那定、三唑仑和左吡登禁止用于洛匹那韦/利托那韦口服溶液治疗的病人，因为它们可能与洛匹那韦/利托那韦口服溶液发生相互作用，产生严重并发症的危险
硝酸异山梨酯注射液	钙通道阻滞剂	药效提高	合并服用具有降低血压作用的药物，例如血管舒张药、降压药(如β-肾上腺素受体阻滞剂、利尿剂、钙通道阻滞剂、ACE抑制剂)、神经松弛剂或三环类抗抑郁药以及酒精，可能会增强硝酸异山梨酯注射液的降压作用
氢溴酸加兰他敏片	红霉素	药效降低	与红霉素合用，可减低氢溴酸加兰他敏片的疗效
硝苯地平	细胞色素P4503A4	药效降低	利福平:具有很强的诱导细胞色素P4503A4系统的作用，如与之合用，硝苯地平的生物利用度会降低而降低其疗效
注射用埃索美拉唑钠	地西泮	药效提高	CYP2C19是埃索美拉唑的主要代谢酶，故当注射用埃索美拉唑钠与经CYP2C19代谢的药物(如地西泮、西酞普兰、丙米嗪、氯米帕明、苯妥英等)合用时，这些药物的血浆浓度可被升高，可能需要降低剂量
丙戊酸	红霉素	药效提高	当与甲氰咪胍或红霉素同时应用时，血清丙戊酸水平可以增高（由于肝脏代谢等降低的结果）
氯化钠	地西泮	药效降低，不良反应增加	氯化钠与地西泮注射液配伍会出现浑浊或产生沉淀，应避免与之配伍使用
布洛芬	呋喃苯胺酸	药效降低	布洛芬与呋塞米（呋喃苯胺酸）同用时，后者的排钠和降压作用减弱；与抗血压药同用时，也降低后者的降压效果
去氧氟尿苷分散片	索立夫定	不良反应增加	抗病毒药索立夫定（Sorivudine）与去氧氟尿苷分散片或氟尿嘧啶并用时，可阻碍后者代谢，导致血液中浓度升高，对骨髓抑制显著，出现严重血液毒性可导致死亡，故严禁并用
曲马多	卡马西平	药效降低	含卡马西平药物：可降低曲马多的镇痛效果
注射用奥硝唑	维库溴铵	药效降低	注射用奥硝唑可延缓肌肉松弛剂维库溴铵的作用
注射用头孢地秦钠	两性霉素B	不良反应增加	注射用头孢地秦钠可加强具有潜在肾毒性药物的毒性作用，如与氨基甙类、两性霉素B、环孢素、顺铂、万古霉素、多粘菌素B或粘菌素同时或先后使用时，应密切监测肾功能
维帕他韦	依非韦伦	药效降低	中度P-gp诱导剂或中度CYP诱导剂类药品（如奥卡西平、莫达非尼或依非韦伦）可能会降低索磷布韦或维帕他韦的血浆浓度，从而导致Epclusa的疗效降低
利多卡因	纳多洛尔	药效提高，不良反应增加	与西咪替丁以及β受体阻断剂如，普萘洛尔、美托洛尔、纳多洛尔合用，利多卡因经肝脏代谢受抑制，利多卡因血浓度增加，可发生心脏和神经系统不良反应，应调整利多卡因剂量，并应心电图监护及监测利多卡因血药浓度
辛伐他汀	免疫抑制剂	不良反应增加	辛伐他汀与免疫抑制剂如环孢素、红霉素、吉非罗齐、烟酸等合用可增加肌溶解和急性肾功能衰竭发生的危险
维生素A	考来烯胺	药效降低	考来烯胺(colestyramine)、矿物油、新霉素、硫糖铝能干扰维生素A吸收
特立氟胺	左炔诺孕酮	药效提高	特立氟胺片可能使炔雌醇和左炔诺孕酮的全身暴露增加
利福喷丁	达卡巴嗪	药效降低，不良反应增加	利福喷丁可诱导肝微粒体酶，增加抗肿瘤药达卡巴嗪(dacarbazine)、环磷酰胺的代谢，形成烷化代谢物，促使白细胞减低，因此需调整剂量
对乙酰氨基酚	颠茄	不良反应增加	应用巴比妥类（如苯巴比妥）或解痉药（如颠茄）的患者，长期使用对乙酰氨基酚时可致肝脏损害
利多卡因	普萘洛尔	药效提高，不良反应增加	与西米替丁以及与β受体阻断剂如：普萘洛尔、美托洛尔、纳多洛尔合用，利多卡因经肝脏代谢受抑制，利多卡因血浓度增加，可发生心脏和神经系统不良反应，应调整利多卡因剂量，并应心电图监护及监测利多卡因血药浓度
阿利吉仑	克拉霉素	药效提高	由于P-gp抑制剂升高药物组织浓度的程度要大于血浆浓度，因此阿利吉仑与酮康唑或其他中效P-gp抑制剂（伊曲康唑、克拉霉素、泰利霉素、红霉素、胺碘酮）联合用药时需谨慎
西索米星氯化钠	头孢噻吩	药效降低，不良反应增加	西索米星氯化钠不宜与两性霉素B、头孢噻吩、呋喃妥英钠、磺胺嘧啶钠和四环素等(以上均为注射液)联合应用，因可发生配伍禁忌
利福平	地西泮	药效降低	利福平与地西泮（安定）合用可增加后者的消除，使其血药浓度减低，故需调整剂量
奥硝唑	抗凝药	药效提高	奥硝唑能抑制抗凝药华法林的代谢，使其半衰期延长，增强抗凝药的药效
维生素C钙	华法令	药效降低	维生素C钙与肝素或华法令联用，可引起凝血酶原时间缩短
戊巴比妥	酰胺类	药效降低	戊巴比妥与卡马西平和琥珀酰胺类药合用时可使这二类药物的清除半衰期缩短而血药浓度降低
雷贝拉唑	酮康唑	药效提高	例如，正常受试者如果每天同时服用酮康唑与20mg雷贝拉唑钠，会使酮康唑的生物利用度减少大约30%；同时服用地高辛，会使地高辛的AUC和Cmax值分别增加19%和29%
利多卡因Ⅰ	甘露醇	药效提高，不良反应增加	与西咪替丁以及b受体阻断剂如，普萘洛尔、美托洛尔、纳多洛尔合用，利多卡因经肝脏代谢受抑制，利多卡因血浓度增加，可发生心脏和神经系统不良反应，应调整利多卡因剂量，并应心电图监护及监测利多卡因血药浓度；（2）巴比妥类药物可促进利多卡因代谢，两药合用可引起心动过缓，窦性停搏；（3）与普鲁卡因胺合用，可产生一过性谵妄及幻觉，但不影响利多卡因Ⅰ血药浓度；（4）异丙基肾上腺素因增加肝血流量，可使利多卡因Ⅰ的总清除率升高；去甲肾上腺素因减少肝血流量，可使利多卡因Ⅰ总清除率下降；（5）与下列药品有配伍禁忌：苯巴比妥，硫喷妥钠，硝普钠，甘露醇，两性霉素B，氨苄西林，磺胺嘧啶
普鲁卡因胺	抗酸药	不良反应增加	降压药合用，尤其静注普鲁卡因胺时，降压作用可增强；④与拟胆碱药合用时，普鲁卡因胺可抑制这类药对横纹肌的效应；⑤与神经肌肉阻滞剂（包括去极化型和非去极化型阻滞剂）合用时，神经肌肉接头的阻滞作用增强，时效延长；⑥酒精可以增加该药的清除率，缩短其半衰期；⑦抗酸药物可以降低其生物利用度，因此不建议两者合用；⑧西咪替丁可以降低普鲁卡因胺和N-乙酰普鲁卡因胺的肾清除率，因此两药合用时需减低普鲁卡因胺的用量；⑨雷尼替丁可影响该药在肾脏的代谢，合用时注意调整用量；⑩甲氧苄啶可以降低普鲁卡因胺和N-乙酰普鲁卡因胺的肾清除率，合用时需减低普鲁卡因胺的用量
盐酸左氧氟沙星片	硫糖铝	药效降低	盐酸左氧氟沙星片与含镁或铝的抗酸剂、硫糖铝、金属阳离子（如铁）、含锌的多种维生素制剂等药物同时使用时将干扰胃肠道对盐酸左氧氟沙星片的吸收，使该药在各系统内的浓度明显降低
氟哌啶醇	苯丙胺	药效降低	氟哌啶醇与苯丙胺合用，可降低后者的作用
胰岛素	抗肿瘤药	药效降低，不良反应增加	抗凝血药、水杨酸盐、磺胺类药及抗肿瘤药甲氨喋呤等可与胰岛素竞争和血浆蛋白结合，从而使血液中游离胰岛素水平增高
克拉霉素	匹莫齐特	药效提高，不良反应增加	克拉霉素与西沙必利、匹莫齐特合用会升高后者血浓度，导致Q-T间期延长，心率失常如室性心动过速、室颤和充血性心力衰竭
阿托品	扑米酮	不良反应增加	与金刚烷胺、吩噻嗪类药、其他抗胆碱药、扑米酮、普鲁卡因胺、三环类抗抑郁药伍用，阿托品的毒副反应可加剧
麻黄碱	磺胺嘧啶	药效降低，不良反应增加	麻黄碱与磺胺嘧啶，呋喃妥因等呈配伍禁忌
头孢呋辛酯	抗酸药	药效降低	头孢呋辛酯与抗酸药合用可减少头孢呋辛酯的吸收
氮卓斯汀	雷尼替丁	药效提高	口服氮卓斯汀（4mg,2次/天），同时口服西米替丁（400mg,2次/天）可使氮卓斯汀的生物利用度提高65%，与雷尼替丁（150mg,2次/天）同时服用，则对氮卓斯汀的药物代谢无影响
奎宁	噻吨类	不良反应增加	酸药及含铝制剂能延缓或减少奎宁的吸收；②抗凝药与奎宁合用后，抗凝作用可增强；③肌肉松弛药如琥珀胆碱、筒箭毒碱等与奎宁合同，可能会引起呼吸抑制；④奎尼丁与奎宁合用，金鸡纳反应可增加；⑤尿液碱化剂如碳酸氢钠等，可增加肾小管对奎宁的重吸收，导致奎宁血药浓度与毒性的增加；⑥与维生素K合用可增加奎宁的吸收；⑦与布克利嗪、赛克利嗪、美克利嗪、吩噻嗪类、噻吨类、曲美苄胺（trimethofenzamide）、氨基苷类抗生素合用可导致耳鸣、眩晕；⑧与硝苯地平（硝苯啶）合用，游离的奎宁浓度增加
甲氧苄啶	苯妥英	药效提高	甲氧苄啶可干扰苯妥英的肝内代谢，增加苯妥英的半衰期(t1/2)达50%，并使其清除率降低
硝酸甘油	双氢麦角胺	药效提高	据报道，当伴随使用双氢麦角胺时，硝酸甘油能增加血液中的双氢麦角胺的水平，从而增加它的升血压效应
利福平	异烟肼	药效提高，不良反应增加	利福平可抑制卡马西平的代谢，使其血药浓度增高，引起毒性反应；卡马西平则可诱导异烟肼的微粒体代谢，使具有肝毒性的中间代谢物增加
异丙嗪	降压药	药效提高	溴苄铵、异喹胍或胍乙啶等降压药与异丙嗪同用时，前者的降压效应增强
利多卡因	纳多洛尔	药效提高，不良反应增加	与西咪替丁以及β受体阻断剂如普萘洛尔、美托洛尔、纳多洛尔合用，利多卡因经肝脏代谢受抑制，利多卡因血浓度增加，可发生心脏和神经系统不良反应，应调整利多卡因剂量，并应用心电图监护及监测利多卡因血药浓度；
头孢哌酮	乳酸钠林格	药效降低，不良反应增加	由于头孢哌酮与乳酸钠林格注射液混合后有配伍禁忌，因此应避免在最初溶解时使用此溶液
七氟烷	维库溴铵	药效提高	当用作阿芬太尼—N2O麻醉的补充时，七氟烷和异氟烷同样可以强化泮库溴铵，维库溴铵和阿曲库铵的神经肌肉阻断作用
咪达普利	降压药	药效提高	其他有降压作用的药物(降压药、硝酸类制剂等)也可增强咪达普利的降压作用
辛伐他汀	奈法唑酮	不良反应增加	当辛伐他汀与其他在治疗剂量下对细胞色素P4503A4有明显抑制作用的药物（如：环孢霉素、米贝地尔、伊曲康唑、酮康唑、红霉素、克拉霉素和奈法唑酮）或纤维酸类衍生物或烟酸合用时，导致横纹肌溶解的危险性增高
托特罗定	抗真菌药	药效提高，不良反应增加	不建议与强CYP3A4抑制剂，如大环内酯抗生素（如，红霉素和克拉霉素），抗真菌药（如，酮康唑，咪康唑和伊曲康唑）和抗蛋白酶合并全身给药，因为托特罗定在CYP2D6弱代谢者中的血清浓度会升高，（之后）出现过量的风险（见药物过量）
非诺贝特	苯妥英	药效提高	非诺贝特与其它高蛋白结合率的药物合用时，可使它们的游离型增加，药效增强，如甲苯磺丁脲及其它磺脲类降糖药、苯妥英、呋塞米等，在降血脂治疗期间服用上述药物，则应调整降糖药及其它药的剂量
克拉维酸钾	口服避孕药	药效降低	克拉维酸钾可刺激雌激素代谢或减少其肠肝循环，因此，可降低口服避孕药的效果
四环素	苯妥英	药效降低	由于巴比妥类、苯妥英或卡马西平可诱导微粒体酶的活性致使四环素血药浓度降低，故合用时须调整四环素的剂量
阿莫西林克拉维酸钾	雌激素	药效降低	莫西林克拉维酸钾可刺激雌激素代谢或减少其肠肝循环，因此可降低口服避孕药的效果
利多卡因	普萘洛尔	药效提高，不良反应增加	与西咪替丁以及与β受体阻滞剂如，普萘洛尔、美托洛尔、纳多洛尔合用，利多卡因经肝脏代谢受抑制，利多卡因血浓度增加，可发生心脏和神经系统不良反应．应调整利多卡因剂量，并应心电图监护及监测利多卡因血药浓度
奥硝唑	维库溴铵	药效提高	奥硝唑可延长维库溴铵的肌肉松弛作用
利多卡因Ⅱ	磺胺嘧啶	药效提高，不良反应增加	与西咪替丁以及b受体阻断剂如，普萘洛尔、美托洛尔、纳多洛尔合用，利多卡因经肝脏代谢受抑制，利多卡因血浓度增加，可发生心脏和神经系统不良反应，应调整利多卡因剂量，并应心电图监护及监测利多卡因血药浓度；（2）巴比妥类药物可促进利多卡因代谢，两药合用可引起心动过缓，窦性停搏；（3）与普鲁卡因胺合用，可产生一过性谵妄及幻觉，但不影响利多卡因Ⅱ血药浓度；（4）异丙基肾上腺素因增加肝血流量，可使利多卡因Ⅱ的总清除率升高；去甲肾上腺素因减少肝血流量，可使利多卡因Ⅱ总清除率下降；（5）与下列药品有配伍禁忌：苯巴比妥，硫喷妥钠，硝普钠，甘露醇，两性霉素B，氨苄西林，磺胺嘧啶
维生素E	氢氧化铝	药效降低	大量氢氧化铝可使小肠上段的胆酸沉淀降低脂溶性维生素E的吸收.
阿莫西林	丙磺舒	药效提高	丙磺舒竞争性地减少阿莫西林的肾小管分泌，两者同时应用可引起阿莫西林血浓度升高、半衰期延长
非洛地平	苯巴比妥	药效降低	细胞色素P450诱导剂：卡马西平、苯妥英、苯巴比妥和利福平等P450诱导剂能增加非洛地平的代谢
甲地高辛	奎尼丁	药效提高，不良反应增加	与奎尼丁合用，可使甲地高辛血药浓度提高约一倍，提高程度与奎尼丁用量相关，甚至可达到中毒浓度，即使停用地高辛，其血药浓度仍继续上升，这是奎尼丁从组织结合处置换出地高辛，减少其分布容积之故
地尔硫卓	卡马西平	药效提高，不良反应增加	卡马西平：地尔硫卓与卡马西平合用后，一些病例中可使卡马西平的血药浓度增高40%-72%而导致毒性
甲泼尼龙	苯巴比妥	药效降低	--对肝酶有诱导作用的药物（例如苯巴比妥、苯妥英钠和利福平）可能增加甲泼尼龙的清除
三维葡磷钙咀嚼片	四环素类	药效降低	三维葡磷钙咀嚼片与苯妥英钠类、四环素类药物同用，二者吸收均减少
利福平	环磷酰胺	药效降低，不良反应增加	利福平可诱导肝微粒体酶，增加抗肿瘤药达卡巴嗪、环磷酰胺的代谢，烷化代谢物的形成，促使白细胞降低，因此需调整剂量
缬沙坦	环孢霉素	药效提高	合并使用性转运蛋白抑制剂（例如，利福平，环孢霉素）或者外排性转运蛋白抑制剂（例如，利托那韦）可能会增加缬沙坦的全身暴露量
美洛西林	丙磺舒	药效提高	丙磺舒可抑制美洛西林的肾排泄
保泰松	利尿剂	不良反应增加	保泰松与利尿剂氨苯蝶啶合用可引起肾功能损害
布洛伪麻软胶囊	甲氨蝶呤	药效提高，不良反应增加	布洛伪麻软胶囊与地高辛、甲氨蝶呤、口服降糖药同时服用，能使这些药物的血药浓度增高，不良反应增加
加替沙星葡萄糖	丙磺舒	药效提高	加替沙星葡萄糖与丙磺舒合用,可减缓加替沙星经肾排除
丙戊酸	消胆胺	药效降低	消胆胺可能降低丙戊酸的吸收
双氯芬酸钠	苯妥英	药效提高，不良反应增加	苯妥英：当双氯芬酸钠与苯妥英合用时，由于苯妥英的暴露量可能会升高，因此建议监控苯妥英的血浆浓度
度拉糖肽	地高辛	药效降低	地高辛稳态时连续使用两次度拉糖肽，地高辛的整体暴露（AUCt）和tmax不变；Cmax降低了22%
非索非那定	酮康唑	药效提高	盐酸非索非那定虽然表现出较小的肝脏代谢率（约5%），但当与红霉素、酮康唑伍用时会导致盐酸非索非那定的血药浓度升高
普鲁卡因胺	降压药	药效提高	降压药合用，尤其静注普鲁卡因胺时，降压作用可增强；④与拟胆碱药合用时，普鲁卡因胺可抑制这类药对横纹肌的效应；⑤与神经肌肉阻滞剂（包括去极化型和非去极化型阻滞剂）合用时，神经肌肉接头的阻滞作用增强，时效延长；⑥酒精可以增加该药的清除率，缩短其半衰期；⑦抗酸药物可以降低其生物利用度，因此不建议两者合用；⑧西咪替丁可以降低普鲁卡因胺和N-乙酰普鲁卡因胺的肾清除率，因此两药合用时需减低普鲁卡因胺的用量；⑨雷尼替丁可影响该药在肾脏的代谢，合用时注意调整用量；⑩甲氧苄啶可以降低普鲁卡因胺和N-乙酰普鲁卡因胺的肾清除率，合用时需减低普鲁卡因胺的用量
单硝酸异山梨酯Ⅱ	去甲肾上腺素	药效降低	拟交感神经类药（如肾上腺素、去甲肾上腺素或麻黄碱等）可降低单硝酸异山梨酯Ⅱ的抗心绞痛效应
氯化铵	呋喃妥因	药效降低，不良反应增加	氯化铵与磺胺嘧啶、呋喃妥因配伍禁忌
溴丙胺太林	地高辛	药效降低	如红霉素可因在胃内停留过长而受到胃酸分解，降低疗效，对乙酰氨基酚的吸收可被延迟，血浆峰浓度降低；地高辛的血浆浓度可因同用溴丙胺太林而提高
肌苷氯化钠注射液	盐酸四环素	药效降低，不良反应增加	肌苷氯化钠注射液禁与下列注射液配伍：乳清酸、氯霉素、双嘧达莫、盐酸山梗菜碱、硫酸阿托品、氢溴酸东莨菪碱、盐酸氯丙嗪、盐酸异丙嗪、马来酸麦角新碱、盐酸普鲁卡因、硫喷妥钠、苯妥英钠、氯氮卓、盐酸去甲肾上腺素、盐酸丁卡因、利血平、硝普钠、降压嗪、呋噻米、利尿酸钠、促皮质素、维生素B12、盐酸苯海拉明、马来酸氯苯那敏、细胞色素C、盐酸万古霉素、盐酸四环素、二盐酸奎宁、盐酸阿糖胞苷、硫酸长春新碱以及所有菌苗和疫苗
氯化钠	吡咯他尼	药效降低	氯化钠与碱性药液(如呋喃苯胺酸、甲氨蝶呤、氟尿嘧啶、吡咯他尼等注射液)或鬼臼乙叉苷注射液配伍会发生浑浊或结晶析出
布洛芬混悬液	双香豆素	药效提高，不良反应增加	布洛芬混悬液与肝素、双香豆素等抗凝药同用时，可导致凝血酶原时间延长，增加出血倾向
氯化钠	呋喃苯胺酸	药效降低，不良反应增加	氯化钠与碱性注射液(如呋喃苯胺酸、甲氨蝶呤、氟尿嘧啶、吡咯他尼注射液)或鬼臼乙叉甙注射液配伍会发生浑浊或结晶析出，应避免配伍使用
单硝酸异山梨酯	双氢麦角胺	药效提高	同时服用单硝酸异山梨酯和双氢麦角胺，会增加血中双氢麦角胺的水平和它的升压作用
替硝唑	苯巴比妥	药效降低	同时应用苯妥英钠、苯巴比妥等诱导肝微粒体酶的药物，可加强替硝唑代谢，使血药浓度下降，而苯妥英钠排泄减慢
哌拉西林	丙磺舒	药效提高	与其他青霉素类相似，特治星®与丙磺舒合并应用可使哌拉西林和他唑巴坦的半衰期延长（哌拉西林的半衰期延长21%，他唑巴坦的半衰期延长71%）、肾脏清除率降低
多巴丝肼	抗胆碱能药物	药效提高，不良反应增加	多巴丝肼可与其他抗帕金森病药物（如抗胆碱能药物、金刚烷胺、溴隐亭和多巴胺受体激动剂等）联合使用，尽管治疗作用和不良反应可能同时增加
卡维地洛	胍乙啶	药效提高	卡维地洛与利血平、胍乙啶、甲多巴、可乐定或胍法辛合用能引起心率的进一步减慢
哌拉西林	他唑巴坦	药效提高	与其他青霉素类相似，哌拉西林/他唑巴坦与丙磺舒合并应用可使哌拉西林和他唑巴坦的半衰期延长(哌拉西林的半衰期延长21%，他唑巴坦的半衰期延长71%)、肾脏清除率降低
甲氧氯普胺	西咪替丁	药效降低	与西咪替丁、慢溶型剂型地高辛同用，后者的胃肠道吸收减少，如间隔2小时服用可以减少这种影响；甲氧氯普胺还可增加地高辛的胆汁排出，从而改变其血浓度；
舒巴坦	乳酸钠林格	药效降低，不良反应增加	由于舒巴坦与乳酸钠林格注射液混合后有配伍禁忌，因此应避免在最初溶解时使用此溶液
托特罗定	咪康唑	药效提高，不良反应增加	不建议与强CYP3A4抑制剂，如大环内酯抗生素（如，红霉素和克拉霉素），抗真菌药（如，酮康唑，咪康唑和伊曲康唑）和抗蛋白酶合并全身给药，因为托特罗定在CYP2D6弱代谢者中的血清浓度会升高，（之后）出现过量的风险（见药物过量）
利福平	妥卡尼	药效降低	据报道利福平可加快下列药物的代谢：抗惊厥药(如苯妥英)，抗心律失常药(如双异丙吡按、美西律、奎尼丁、妥卡尼)，口服抗凝血药，抗真菌药(如氟康唑、伊曲康唑、酮康唑等)，巴比土酸盐，β-阻滞剂，钙离子阻滞剂(如硫氮卓酮、硝苯吡啶、维拉帕米等)，氯霉素、克拉霉素、皮质类固醇、环孢霉素、洋地黄甙类、氯贝特、激素类避孕药，氨苯砜、安定、强力霉素、氟喹诺酮类(如环丙沙星)、氟哌啶醇、口服降糖药(磺酰脲)，左旋甲状腺素、美沙酮、麻醉性镇痛药，去甲替林、孕激素、奎林、茶碱、他克莫司、三环类抗抑郁药(阿米替林、去甲替林)和叠氮胸苷
奥硝唑	维库溴铵	药效提高，不良反应增加	奥硝唑可延长维库溴铵的肌肉松驰作用，降低其疗效并可影响凝血
奎宁	吩噻嗪类	不良反应增加	酸药及含铝制剂能延缓或减少奎宁的吸收；②抗凝药与奎宁合用后，抗凝作用可增强；③肌肉松弛药如琥珀胆碱、筒箭毒碱等与奎宁合同，可能会引起呼吸抑制；④奎尼丁与奎宁合用，金鸡纳反应可增加；⑤尿液碱化剂如碳酸氢钠等，可增加肾小管对奎宁的重吸收，导致奎宁血药浓度与毒性的增加；⑥与维生素K合用可增加奎宁的吸收；⑦与布克利嗪、赛克利嗪、美克利嗪、吩噻嗪类、噻吨类、曲美苄胺（trimethofenzamide）、氨基苷类抗生素合用可导致耳鸣、眩晕；⑧与硝苯地平（硝苯啶）合用，游离的奎宁浓度增加
洛伐他汀	阿奇霉素	不良反应增加	洛伐他汀与免疫抑制剂如环孢素、阿奇霉素、克拉霉素、红霉素、达那唑、伊曲康唑、吉非罗齐、烟酸等合用可增加肌溶解急性肾功能衰竭发生的危险
吉非贝齐	苯妥英	药效提高	吉非贝齐与其它高蛋白结合率的药物合用时，也可将它们从蛋白结合位点上替换下来，导致其作用加强，如甲苯磺丁脲及其它磺脲类降糖药、苯妥英、呋塞米等，在降血脂治疗期间服用上述药物，则应调整降糖药及其它药的剂量
茶苯海明缓释胶囊	巴比妥类	药效降低	茶苯海明缓释胶囊能短暂地影响巴比妥类等的吸收
贝那普利	锂	药效提高，不良反应增加	由于噻嗪类利尿剂可以减少肾脏对锂的清除率，因此噻嗪类利尿剂与ACE抑制剂联合使用时（如贝那普利），发生锂中毒危险有可能会升高
布洛芬	双香豆素	药效提高，不良反应增加	布洛芬与肝素，双香豆素等抗凝药同用时，可导致凝血酶原时间延长，增加出血倾向
维生素D2	钙	不良反应增加	大量钙剂或利尿药与常用量维生素D2并用，有发生高钙血症的危险
阿莫西林	保泰松	药效提高，不良反应增加	．阿司匹林、吲哚美辛、保泰松、磺胺药可减少阿莫西林在肾小管的排泄，因而使阿莫西林的血药浓度升高，血消除半衰期（t1/2β）延长，毒性也可能增加
辛伐他汀	环孢霉素	不良反应增加	当辛伐他汀与其它在治疗剂量下对细胞色素P4503A4有明显抑制作用的药物（如：环孢霉素、米贝地尔、伊曲康唑、酮康唑、红霉素、克拉霉素和奈法唑酮）或纤维酸类衍生物或盐酸合用时，导致横纹肌溶解的危险性增高
利鲁唑	喹诺酮类	药效提高	CYP1A2的抑制剂(如咖啡因，双氮芬酸，地西泮，尼麦角林，氣米帕明，丙咪嗪，氟伏沙明，非那西汀，茶碱，阿米替林以及喹诺酮类)可潜在降低利鲁唑的清除率，而CYP1A2的诱导剂(如卷烟烟气，炭烤的食物，利福平以及奥美拉唑)可增加利鲁唑的清除率
替米沙坦	地高辛	药效提高	替米沙坦和地高辛同时使用，可使地高辛的峰浓度和谷浓度分别升高49%和20%
头孢哌酮	氨茶碱	药效降低，不良反应增加	头孢哌酮与下列药物注射剂有配伍禁忌：阿米卡星、庆大霉素、卡那霉素B、多西环素、甲氯芬酯、阿马林(缓脉灵)、苯海拉明、门冬酸钾镁、盐酸羟嗪(安太乐)、普鲁卡因胺、氨茶碱、丙氯拉嗪、细胞色素C、喷他佐辛(镇痛新)、抑肽酶等
哌柏西利	瑞舒伐他汀	药效提高，不良反应增加	因此，哌柏西利与P-gp（如，地高辛、达比加群、秋水仙碱）或BCRP（如，普伐他汀、瑞舒伐他汀、柳氮磺胺吡啶）的底物类药品合并用药可增加它们的治疗作用和不良反应
维生素B6	青霉胺	不良反应增加	6．氯霉类、坏丝氨酸、乙硫异烟胺、盐酸肼酞嗪、免疫抑制剂包括肾上腺皮质激素、环磷酰胺、环孢素、异烟肼、青霉胺等药物可拮抗维生素B6或增加维生素B6经肾排泄，可引起贫血或周围神经炎
克拉霉素	奎尼丁	不良反应增加	有上市后报道，当克拉霉素和奎尼丁或丙吡胺合用时有尖端扭转型室速现象发生
枸橼酸铁铵维B1Ⅰ	维生素C	药效提高，不良反应增加	与维生素C同服，可增加枸橼酸铁铵维B1Ⅰ吸收，但也易致胃肠道反应
盐酸林可霉素口服溶液	氯霉素	药效降低	霉素或红霉素在靶位上均可置换盐酸林可霉素口服溶液，或阻抑盐酸林可霉素口服溶液与细菌核糖体50S亚基的结合，体外试验显示盐酸林可霉素口服溶液与红霉素具拮抗作用，故盐酸林可霉素口服溶液不宜与氯霉素或红霉素合用
克拉霉素	卡马西平	药效降低	诱导CYP3A的药物（利福平、苯妥英、卡马西平、苯巴比妥和金丝桃素）可诱导克拉霉素的代谢
萘普生	呋塞米	药效降低	萘普生可降低呋塞米的排纳和降压作用
碳酸锂	吩噻嗪	药效降低	碳酸锂与氯丙嗪及其他吩噻嗪衍生物合用时，可使氯丙嗪的血药浓度降低
咪达唑仑	乙醇	药效提高	乙醇：可能增强咪达唑仑的镇静作用
氟替卡松	酮康唑	药效提高，不良反应增加	由于强效CYP3A4抑制剂（例如，酮康唑、利托那韦）可能使糠酸氟替卡松和维兰特罗的全身暴露量增加，应避免联合应用，除非获益高于全身糖皮质激素副反应，此情况下应监测患者的全身糖皮质激素副反应
依巴斯汀	酮康唑	药效提高，不良反应增加	研究表明当依巴斯汀与酮康唑或红霉素（已知这两种药物均可延长QT间期）联合应用时，有药物代谢动力学及药效动力学方面的相互作用，使依巴斯汀的血药浓度增高—尽管较以上两种药物单独使用仅使QT间期延长10ms，并且依巴斯汀应慎用于同时服用酮康唑或红霉素的患者
异丙托溴铵	肾上腺素	不良反应增加	同时使用黄嘌呤衍生物、及其他的β－肾上腺素能类和抗胆碱能类可増加异丙托溴铵副作用
氧	地高辛	药效降低	西咪替丁、慢溶型剂型地高辛同用，后者的胃肠道吸收减少，如间隔2小时服用可以减少这种影响；氧还可增加地高辛的胆汁排出，从而改变其血浓度
双氯芬酸	甲氨喋呤	药效提高，不良反应增加	双氯芬酸可降低甲氨蝶呤的排泄，增高其血浓度，甚至可达中毒水平，故双氯芬酸不应与中或大剂量甲氨喋呤同用
普萘洛尔	抗高血压药物	不良反应增加	与抗高血压药物相互作用：普萘洛尔与利血平合用，可导致体位性低血压、心动过缓、头晕、晕厥
替硝唑	甲硝唑	药效提高	华法林和其他口服香豆素抗凝血药：鉴于甲硝唑的相关报道，替硝唑可以增强华法林及其他香豆素抗凝血剂的药效，从而导致凝血酶原时间延长
异丙嗪	胍乙啶	药效提高	溴苄铵、异喹胍或胍乙啶等降压药与异丙嗪同用时，前者的降压效应增强
阿立哌唑	氟西汀	药效提高	CYP3A4抑制剂（如酮康唑）或CYP2D6抑制剂（如奎尼丁、氟西汀、帕罗西汀）可以抑制阿立哌唑消除，使血药浓度升高
哌拉西林	丙磺舒	药效提高	与其他青霉素类相似，哌拉西林/他唑巴坦与丙磺舒合并应用可使哌拉西林和他唑巴坦的半衰期延长（哌拉西林的半衰期延长21%，他唑巴坦的半衰期延长71%）、肾脏清除率降低
注射用奥美拉唑钠	红霉素	药效提高	当注射用奥美拉唑钠与克拉霉素或红霉素合用时，奥美拉唑血浆浓度会增加
苯巴比妥	苯妥英钠	药效降低	苯巴比妥与苯妥英钠合用，苯妥英钠的代谢加快，效应降低
阿米卡星	磺胺嘧啶	药效降低，不良反应增加	阿米卡星不宜与两性霉素B、头孢噻吩、磺胺嘧啶和四环素等注射剂联合应用，因可发生配伍禁忌
盐酸左布诺洛尔滴眼液	β-受体阻滞剂	药效提高	反之，全身性应用β-受体阻滞剂对盐酸左布诺洛尔滴眼液的降低眼压作用亦有相加作用
利福平	维拉帕米	药效降低	据报道利福平可加快下列药物的代谢：抗惊厥药(如苯妥英)，抗心律失常药(如双异丙吡按、美西律、奎尼丁、妥卡尼)，口服抗凝血药，抗真菌药(如氟康唑、伊曲康唑、酮康唑等)，巴比土酸盐，β-阻滞剂，钙离子阻滞剂(如硫氮卓酮、硝苯吡啶、维拉帕米等)，氯霉素、克拉霉素、皮质类固醇、环孢霉素、洋地黄甙类、氯贝特、激素类避孕药，氨苯砜、安定、强力霉素、氟喹诺酮类(如环丙沙星)、氟哌啶醇、口服降糖药(磺酰脲)，左旋甲状腺素、美沙酮、麻醉性镇痛药，去甲替林、孕激素、奎林、茶碱、他克莫司、三环类抗抑郁药(阿米替林、去甲替林)和叠氮胸苷
硝苯地平	卡马西平	药效降低	卡马西平:目前尚未进行硝苯地平与卡马西平是否有潜在相互作用的研究，但是因为卡马西平可诱导酶的活性，从而导致与硝苯地平结构相似的钙离子通道阻滞剂尼莫地平的血药浓度降低，因此不能排除二者合用可降低硝苯地平的血药浓度，从而降低疗效
氟康唑	他克莫司	不良反应增加	有报道氟康唑与他克莫司合用时可引起肾毒性
头孢丙烯	丙磺舒	药效提高，不良反应增加	已有氨基糖苷类抗生素和头孢菌素合用引起肾毒性的报道，与丙磺舒合用使头孢丙烯的AUC增加一倍
维U颠茄铝Ⅲ	左旋多巴	药效提高	维U颠茄铝Ⅲ与左旋多巴合用时，吸收可能增加，胃排空缓慢者尤其明显
阿莫西林克拉维酸钾干混悬剂	四环素类	药效降低	氯霉素、红霉素、四环素类等抗生素和磺胺药等抑菌药可干扰阿莫西林克拉维酸钾干混悬剂的杀菌活性，因此不宜与阿莫西林克拉维酸钾干混悬剂合用，尤其在治疗脑膜炎或急需杀菌药的严重感染时
硝苯地平	西沙必利	药效提高	西沙必利与硝苯地平合用可使硝苯地平的血浆浓度升高
溴隐亭	酒精	不良反应增加	酒精可降低溴隐亭的耐受性
维帕他韦	苯妥英	药效降低	P-gp强效诱导剂或CYP2B6、CYP2C8或CYP3A4强效诱导剂类药品（例如利福平、利福布丁、圣约翰草、卡马西平、苯巴比妥和苯妥英）可能会降低索磷布韦、维帕他韦和/或伏西瑞韦的血药浓度，从而导致索磷维伏片的疗效降低
复方对乙酰氨基酚Ⅱ	酒精	不良反应增加	复方对乙酰氨基酚Ⅱ不应与含有酒精的饮料、巴比妥类(如苯巴比妥)、解痉药类(如颠茄)同服，因可造成肝损害
肌苷氯化钠注射液	马来酸氯苯那敏	药效降低，不良反应增加	肌苷氯化钠注射液禁与下列注射液配伍：乳清酸、氯霉素、双嘧达莫、盐酸山梗菜碱、硫酸阿托品、氢溴酸东莨菪碱、盐酸氯丙嗪、盐酸异丙嗪、马来酸麦角新碱、盐酸普鲁卡因、硫喷妥钠、苯妥英钠、氯氮卓、盐酸去甲肾上腺素、盐酸丁卡因、利血平、硝普钠、降压嗪、呋噻米、利尿酸钠、促皮质素、维生素B12、盐酸苯海拉明、马来酸氯苯那敏、细胞色素C、盐酸万古霉素、盐酸四环素、二盐酸奎宁、盐酸阿糖胞苷、硫酸长春新碱以及所有菌苗和疫苗
己酮可可碱	降糖药	药效提高	己酮可可碱可增强降压药、降糖药的作用
异烟肼	对乙酰氨基酚	不良反应增加	与对乙酰氨基酚合用时，由于异烟肼可诱导肝细胞色素P450，使前者形成毒性代谢物的量增加，可增加肝毒性及肾毒性
甲氨蝶呤	氟尿嘧啶	药效降低，不良反应增加	有报道甲氨蝶呤与阿糖胞苷、氟尿嘧啶及强的松龙存在配伍禁忌
环丙沙星	茶碱类	药效提高，不良反应增加	环丙沙星与茶碱类合用时可能由于与细胞色素P450结合部位的竞争性抑制，导致茶碱类的肝消除明显减少，血消除半衰期(t1/2)延长，血药浓度升高，出现茶碱中毒症状，如恶心、呕吐、震颤、不安、激动、抽搐、心悸等，故合用时应测定茶碱类血药浓度和调整剂量
甲硝唑呋喃唑酮	苯巴比妥	药效降低	同时应用苯妥英钠、苯巴比妥等诱导肝微粒体酶的药物，可加强甲硝唑呋喃唑酮代谢，使血药浓度下降，而苯妥英钠排泄减慢
精氨酸布洛芬	抗高血压药	药效降低	精氨酸布洛芬与呋塞米（呋喃苯胺酸）同用时，后者的排钠和降压作用减弱；与抗高血压药同用时，也降低后者的降压效果
尼麦角林	降压药	药效提高	尼麦角林能增加降血压药的作用，因此与降压药合用应慎重
奥硝唑氯化钠	维库溴铵	药效提高	奥硝唑氯化钠可延缓肌肉松弛剂维库溴铵的作用
辛伐他汀	烟酸	不良反应增加	辛伐他汀与甲基羟戊二酰辅酶A(HMG-COA)还原酶抑制剂合并用药会增加肌病的发生率和严重程度，这些药物包括吉非贝齐和其他贝特类，以及降脂剂量的烟酸(大于等于1g/d)
伪麻那敏	吩噻嗪类	药效提高	伪麻那敏可增强金刚烷胺、抗胆碱药，氟哌啶醇、吩噻嗪类及拟交感神经药的作用；
拉替拉韦钾片	雌二醇	药效降低	在多剂量给药的药物相互作用试验中，当与拉替拉韦钾片合用和不与拉替拉韦钾片合用时比较，乙炔基雌二醇和NorelgestrominAUC分别是98%和114%
左奥硝唑	炎琥宁	药效降低，不良反应增加	文献报道，奥硝唑与呋布西林钠、萘夫西林钠、奥美拉唑、沃必唑、注射用炎琥宁、阿洛西林钠存在配伍禁忌，左奥硝唑在使用时也应注意
地尔硫卓	卡马西平	药效提高，不良反应增加	卡马西平：对于一些病例，地尔硫卓可使卡马西平血药浓度增高40-72%而导致毒性
青霉素	口服避孕药	药效降低	青霉素可刺激雌激素代谢或减少其肠肝循环，因此，可降低口服避孕药的效果
胍西替柳	碳酸氢钠	药效降低	抗酸药如碳酸氢钠等可加速胍西替柳自尿中的排泄，不宜同用
哌嗪	抗肿瘤药	药效降低，不良反应增加	哌嗪可诱导肝微粒体酶，增加抗肿瘤药达卡巴嗪(dacarbazine)、环磷酰胺的代谢，形成烷化代谢物，促使白细胞减低，因此需调整剂量
对乙酰氨基酚	氯霉素	药效提高，不良反应增加	对乙酰氨基酚与氯霉素合用，可延长后者的半衰期，增强其毒性
茶碱Ⅱ	克林霉素	药效提高，不良反应增加	与克林霉素、林可霉素及某些大环内酯类（红霉素、罗红霉素、克拉霉素）、喹诺酮类抗菌药（伊诺沙星、环丙沙星）合用时，可降低茶碱Ⅱ在肝脏的清除率，使血药浓度升高，甚至出现毒性反应，应在给药前后调整茶碱Ⅱ的用量
茶碱氯化钠	林可霉素	药效提高，不良反应增加	与克林霉素、林可霉素及某些大环内酯类（红霉素、罗红霉素、克拉霉素）、喹诺酮类抗菌药（伊诺沙星、环丙沙星）合用时，可降低茶碱氯化钠在肝脏的清除率，使血药浓度升高，甚至出现毒性反应，应在给药前后调整茶碱氯化钠的用量
达比加群	克拉霉素	药效提高	预计与强效P-gp抑制剂（如：胺碘酮、维拉帕米、奎尼丁、酮康唑、决奈达隆和克拉霉素）的联合使用会导致达比加群血药浓度升高
利托那韦口服溶液	西沙必利	不良反应增加	阿普唑仑、安非他酮、胺碘酮、阿咪唑、苄替地尔、西沙必利、氯拉折帕、氯氮平、右丙氧芬、地西泮、二氢麦角胺、恩卡肢、舒乐安定、麦角胺、氟卡胺、氟西泮、咪达唑仑、哌替啶、匹莫齐特、吡罗昔康、普罗帕酮、奎尼丁、利福布丁、特非那定、三唑仑和左吡登禁止用于利托那韦口服溶液治疗的病人，因为它们可能与利托那韦口服溶液发生相互作用，产生严重并发症的危险
阿莫西林	抗生素	不良反应增加	丙磺舒降低阿莫西林从肾小管中分泌，与阿莫西林合用时会升高阿莫西林的血药浓度，建议不与利尿酸药合用；别嘌呤醇(治痛风药)和阿莫西林合用会增加病人皮疹的发病率，尚未明确阿莫西林引发皮疹是由于因病人体内的别嘌呤醇还是因血尿酸升高引起的，尚未有阿莫西林与别嘌呤醇合用的资料；与其他广谱抗生素相似，阿莫西林可能降低避孕药的药效
环丙沙星	镁	药效降低	含铝或镁的制酸药可减少环丙沙星口服的吸收，建议避免合用
氨苯蝶啶	地高辛	药效提高	氨苯蝶啶可使地高辛半衰期延长
环孢素软胶囊	甲氧氯普胺	药效提高	提高环孢素软胶囊血浆或全血浓度的药品有：酮康唑、氟康唑、伊曲康唑、红霉素、交沙霉素、克拉霉素等大环内酯类抗生素，强力霉素、口服避孕药、普罗帕酮以及地尔硫卓、尼卡地平、维拉帕米等钙拮抗剂，氟伏沙明、乙酰唑胺、甲氧氯普胺、达那唑、甲泼尼龙（高剂量）、别嘌醇、胺碘酮、胆酸及其衍生物、蛋白酶抑制剂
司帕沙星	镁	药效降低	司帕沙星与含有铝、镁、铁的抗酸剂合用时，可降低司帕沙星的吸收，从而降低疗效
甲硝唑	苯巴比妥	药效降低	同时应用诱导肝脏微粒体酶的药物，如苯妥英或苯巴比妥，可加速甲硝唑清除，导致其血药浓度降低
己酮可可碱	抗凝药	药效提高	己酮可可碱可增强降压药、降糖药及抗凝药的药理作用
异烟肼	对乙酰氨基酚	不良反应增加	与对乙酰氨基酚合用时，由于异烟肼可诱导肝细胞色素P450，使前者形成毒性代谢物的量增加,可增加肝毒性及肾毒性
阿莫西林	丙磺舒	药效提高	不推荐阿莫西林与丙磺舒合用，丙磺舒可降低肾小管对阿莫西林的分泌
阿莫西林	吲哚美辛	药效提高，不良反应增加	阿司匹林、吲哚美辛、保泰松、磺胺药可减少阿莫西林在肾小管的排泄，因而使阿莫西林的血药浓度升高，血消除半衰期（t1/2b）延长，毒性也可能增加
罗红霉素Ⅱ	特非那定	不良反应增加	特非那定和阿司咪唑：罗红霉素Ⅱ可导致特非那定和阿司咪唑血药浓度升高，引发严重的室性心律失常
加巴喷丁	氢氧化铝	药效降低	抗酸剂(氢氧化铝)、氢氧化铝降低加巴喷丁的生物利用度大约20%
氯化琥珀胆碱	吩噻嗪类	药效提高	与下列药物合用也须谨慎，如：吩噻嗪类、普鲁卡因胺、奎尼丁、卡那霉素、多粘菌素B、新霉素等有去极化型肌松作用，能增强氯化琥珀胆碱作用
贝尼地平	利福平	药效降低	利福平：利福平诱导肝脏的药物代谢酶，促进钙拮抗剂代谢，可降低贝尼地平的血药浓度，使降压作用减弱
酒石酸西尼必利片	镇痛药	药效降低	阿托品样的抗胆碱能药物和阿片类镇痛药物可能会削弱酒石酸西尼必利片对消化道的作用
文拉法辛	西咪替丁	药效提高	在18例健康志愿者中合并使用文拉法辛和西咪替丁会抑制文拉法辛的首过代谢
利福平	氨苯砜	药效降低	肾上腺皮质激素（糖皮质激素、盐皮质激素）、抗凝药、香豆素或茚满二酮衍生物、口服降血糖药、促皮质激素、氨苯砜、洋地黄苷类、丙吡胺、奎尼丁等与利福平合用时，由于后者对肝微粒体酶活性的刺激作用，可使上述药物的药效减低，因此除地高辛和氨苯砜外，在用利福平前和疗程中上述药物需调整剂量
酮洛芬Ⅱ	抗凝药	药效提高，不良反应增加	酮洛芬Ⅱ与肝素、双香豆素等抗凝药同时使用，可导致凝血酶原时间延长，增加出血倾向；
泛昔洛韦	喷昔洛韦	药效提高	泛昔洛韦与丙磺舒或其他由肾小管主动排泄的药物合用时，可能导致血浆中喷昔洛韦浓度升高
头孢呋辛	碳酸氢钠注射液	药效提高	74%（重量容积比）的碳酸氢钠注射液的PH值对头孢呋辛溶液的颜色影响很大，故不推荐用此溶液稀释头孢呋辛
洛伐他汀	环孢素	不良反应增加	洛伐他汀与免疫抑制剂如环孢素、阿奇霉素、克拉霉素、红霉素、达那唑、伊曲康唑、吉非罗齐、烟酸等合用可增加肌溶解急性肾功能衰竭发生的危险
盐酸左氧氟沙星片	金属阳离子	药效降低	盐酸左氧氟沙星片与含镁或铝的抗酸剂、硫糖铝、金属阳离子（如铁）、含锌的多种维生素制剂等药物同时使用时将干扰胃肠道对盐酸左氧氟沙星片的吸收，使该药在各系统内的浓度明显降低
碳酸氢钠	磺胺嘧啶	药效提高，不良反应增加	与磺吡酮合用时可减少碳酸氢钠中的磺胺嘧啶自肾小管的分泌，其血药浓度升高而持久，易产生毒性反应，因此在应用磺吡酮期间或应用其治疗后可能需要调整碳酸氢钠的剂量
克拉维酸钾	吲哚美辛	药效提高，不良反应增加	阿司匹林、吲哚美辛、保泰松、磺胺药、丙磺舒可减少克拉维酸钾在肾小管的排泄，因而可使克拉维酸钾的血药浓度升高，而且维持较久，血消半衰期延长，毒性也可能增加
环孢素软胶囊	乙酰唑胺	药效提高	提高环孢素软胶囊血浆或全血浓度的药品有：酮康唑、氟康唑、伊曲康唑、红霉素、交沙霉素、克拉霉素等大环内酯类抗生素，强力霉素、口服避孕药、普罗帕酮以及地尔硫卓、尼卡地平、维拉帕米等钙拮抗剂，氟伏沙明、乙酰唑胺、甲氧氯普胺、达那唑、甲泼尼龙（高剂量）、别嘌醇、胺碘酮、胆酸及其衍生物、蛋白酶抑制剂
洛美沙星葡萄糖	丙磺舒	药效提高，不良反应增加	丙磺舒可延迟洛美沙星葡萄糖的排泄，使平均曲线下面积(AUC)增大63%，平均达峰时间(tmax)延长50%，平均峰浓度(Cmax)增高4%；故合用时可因洛美沙星葡萄糖血浓度增高而产生毒性
头孢拉定	复方氯化钠注射液	药效降低，不良反应增加	头孢拉定中含有碳酸钠，因此与含钙溶液如复方氯化钠注射液有配伍禁忌
布洛芬	双香豆素	药效提高，不良反应增加	布洛芬与肝素、双香豆素等抗凝药同用时，可导致凝血酶原时间延长，增加出血倾向，不宜同用
莫达非尼	苯巴比妥	药效降低	此外，由于莫达非尼的代谢消除部分与CYP3A4有关，与CYP3A4的强诱导剂（例如，卡马西平、苯巴比妥、利福平）或者强抑制剂（例如，酮康唑、伊曲康唑）合用会改变莫达非尼的血药浓度
卡马西平	苯妥英	药效降低	苯巴比妥和苯妥英加速卡马西平的代谢，可将卡马西平的t1/2降至9～10小时
阿利吉仑	泰利霉素	药效提高	由于P-gp抑制剂升高药物组织浓度的程度要大于血浆浓度，因此阿利吉仑与酮康唑或其他中效P-gp抑制剂（伊曲康唑、克拉霉素、泰利霉素、红霉素、胺碘酮）联合用药时需谨慎
氯化钠	甲氨蝶呤	药效降低	氯化钠与碱性注射液(如呋喃苯胺酸、甲氨蝶呤、氟尿嘧啶、吡咯他尼注射液)或鬼臼乙叉甙注射液配伍会发生浑浊或结晶析出，应避免配伍使用
萘夫西林	间羟胺	药效降低，不良反应增加	萘夫西林与氨基糖苷类、去甲肾上腺素、间羟胺、苯巴比妥、维生素B族、维生素C等药物存在配伍禁忌，不宜同瓶滴注
可待因	碳酸氢钠	药效降低	碱化药（碳酸氢钠等）、抗酸药（长期大量应用）可增加可待因自尿中排泄，使血药浓度下降
米非司酮	葡萄柚汁	药效提高	其代谢有可能被酮康唑、伊曲康唑、红霉素和葡萄柚汁抑制（增加血清米非司酮水平）》此外，利福平、地塞米松、S.John麦芽汁和某些抗惊厥药（苯妥英、苯巴比妥、卡马西平）可能诱导米非司酮代谢（降低米非司酮血清水平）根据体外抑制资料，联合给予米非司酮可以导致本身是CYP3A4底物的药物血清水平增加，由于米非司酮从体内消除减慢，这种相互作用可以从给药后体内时间延长观察到
阿利吉仑	阿托伐他汀	药效提高	与阿托伐他汀（80mg）联合使用，阿利吉仑（300mg）稳态AUC和Cmax升高50％
阿莫西林克拉维酸钾	丙磺舒	药效提高，不良反应增加	阿司匹林、吲哚美辛、保泰松、磺胺药、丙磺舒可减少阿莫西林克拉维酸钾在肾小管的排泄，因而可使阿莫西林克拉维酸钾的血药浓度升高，而且维持较久，血消半衰期延长，毒性也可能增加
阿咖酚	颠茄	不良反应增加	阿咖酚不应与含有酒精的饮料、巴比妥类(如苯巴比妥)、解痉药类(如颠茄)同服，因可造成肝损害
利多卡因Ⅱ	硫喷妥钠	药效提高，不良反应增加	与西咪替丁以及β受体阻断剂如，普萘洛尔、美托洛尔、纳多洛尔合用，利多卡因经肝脏代谢受抑制，利多卡因血浓度增加，可发生心脏和神经系统不良反应，应调整利多卡因剂量，并应心电图监护及监测利多卡因血药浓度；(2)巴比妥类药物可促进利多卡因代谢，两药合用可引起心动过缓，窦性停搏；(3)与普鲁卡因胺合用，可产生一过性谵妄及幻觉，但不影响利多卡因Ⅱ血药浓度；(4)异丙基肾上腺素因增加肝血流量，可使利多卡因Ⅱ的总清除率升高；去甲肾上腺素因减少肝血流量，可使利多卡因Ⅱ总清除率下降；(5)与下列药品有配伍禁忌：苯巴比妥，硫喷妥钠，硝普钠，甘露醇，两性霉素B，氨苄西林，磺胺嘧啶
西索米星	酰胺类	药效降低	西索米星与β-内酰胺类(头孢菌素类或青霉素类)混合可导致相互失活，需联合应用时必须分瓶注射
辛伐他汀	酮康唑	不良反应增加	当辛伐他汀与其它在治疗剂量下对细胞色素P4503A4有明显抑制作用的药物（如：环孢霉素、米贝地尔、伊曲康唑、酮康唑、红霉素、克拉霉素和奈法唑酮）或纤维酸类衍生物或盐酸合用时，导致横纹肌溶解的危险性增高
硝苯地平	苯妥英	药效降低	与苯妥英合用时，硝苯地平的生物利用度降低从而导致疗效下降
单硝酸异山梨酯Ⅱ	西地那非	药效提高，不良反应增加	和西地那非合用会加强单硝酸异山梨酯Ⅱ的降压作用(见禁忌)，这将导致危及生命的心血管并发症，所以正在接受单硝酸异山梨酯Ⅱ治疗的病人不可使用西地那非
脂肪乳	抗凝剂	药效提高	使用脂肪乳有可能导致出血时间延长与血小板的凝集出现抑制，因此同时接受抗凝治疗的患者，给予脂肪乳时要特别小心，可以考虑减少抗凝剂的使用量
布洛芬	呋喃苯胺酸	药效降低	布洛芬与呋塞米(呋喃苯胺酸)同用时，后者的排钠和降压作用减弱；与抗高血压药同用时，也降低后者的降压效果
头孢孟多	镁	药效降低，不良反应增加	头孢孟多制剂中含有碳酸钠，因而与含有钙或镁的溶液（包括复方氯化钠注射液或复方乳酸钠注射液）有配伍禁忌
布洛芬咀嚼片	双香豆素	药效提高，不良反应增加	布洛芬咀嚼片与肝素、双香豆素（如华法林）等抗凝药同用时，可导致凝血酶原时间延长，增加出血倾向
利多卡因	硝普钠	药效提高，不良反应增加	与西咪替丁以及β受体阻断剂如，普萘洛尔、美托洛尔、纳多洛尔合用，利多卡因经肝脏代谢受抑制，利多卡因血浓度增加，可发生心脏和神经系统不良反应，应调整利多卡因剂量，并应心电图监护及监测利多卡因血药浓度；(2)巴比妥类药物可促进利多卡因代谢，两药合用可引起心动过缓，窦性停搏；(3)与普鲁卡因胺合用，可产生一过性谵妄及幻觉，但不影响利多卡因血药浓度；(4)异丙基肾上腺素因增加肝血流量，可使利多卡因的总清除率升高；去甲肾上腺素因减少肝血流量，可使利多卡因总清除率下降；(5)与下列药品有配伍禁忌：苯巴比妥，硫喷妥钠，硝普钠，甘露醇，两性霉素B，氨苄西林，磺胺嘧啶
利福霉素	达卡巴嗪	药效降低，不良反应增加	利福霉素可诱导肝微粒体酶，增加抗肿瘤药达卡巴嗪(dacarbazine)﹑环磷酰胺的代谢，形成烷化代谢物，促使白细胞减低，因此需调整剂量
盐酸林可霉素口服溶液	红霉素	药效降低	霉素或红霉素在靶位上均可置换盐酸林可霉素口服溶液，或阻抑盐酸林可霉素口服溶液与细菌核糖体50S亚基的结合，体外试验显示盐酸林可霉素口服溶液与红霉素具拮抗作用，故盐酸林可霉素口服溶液不宜与氯霉素或红霉素合用
肝素	阿米卡星	药效降低，不良反应增加	下列药物与肝素有配伍禁忌：卡那霉素、阿米卡星、柔红霉素、乳糖酸红霉素、硫酸庆大霉素、氢化考的松琥珀酸钠、多粘菌素B、阿霉素、妥布霉素、万古霉素、头孢孟多、头孢氧哌唑、头孢噻吩钠、氯喹丙嗪、异丙嗪、麻醉性镇痛药
利多卡因Ⅰ	普萘洛尔	药效提高，不良反应增加	与西咪替丁以及b受体阻断剂如，普萘洛尔、美托洛尔、纳多洛尔合用，利多卡因经肝脏代谢受抑制，利多卡因血浓度增加，可发生心脏和神经系统不良反应，应调整利多卡因剂量，并应心电图监护及监测利多卡因血药浓度；（2）巴比妥类药物可促进利多卡因代谢，两药合用可引起心动过缓，窦性停搏；（3）与普鲁卡因胺合用，可产生一过性谵妄及幻觉，但不影响利多卡因Ⅰ血药浓度；（4）异丙基肾上腺素因增加肝血流量，可使利多卡因Ⅰ的总清除率升高；去甲肾上腺素因减少肝血流量，可使利多卡因Ⅰ总清除率下降；（5）与下列药品有配伍禁忌：苯巴比妥，硫喷妥钠，硝普钠，甘露醇，两性霉素B，氨苄西林，磺胺嘧啶
琥珀酸亚铁片	卡比多巴	药效降低	琥珀酸亚铁片可减少左旋多巴、卡比多巴、甲基多巴及喹诺酮类药物的吸收
单硝酸异山梨酯Ⅰ	西地那非	药效提高，不良反应增加	和治疗勃起功能障碍的5型磷酸二酯酶抑制剂（如西地那非）合用会增加单硝酸异山梨酯Ⅰ的降压作用，可能引起致命的心血管并发症因此使用单硝酸异山梨酯Ⅰ时不能使用5型磷酸二酯酶抑制剂（如西地那非）
西索米星氯化钠	磺胺嘧啶	药效降低，不良反应增加	西索米星氯化钠不宜与两性霉素B、头孢噻吩钠、呋喃妥因钠，磺胺嘧啶钠和四环素（以上均为注射液）联合应用，因可发生配伍禁忌
雷尼替丁	阿扎那韦	药效降低	雷尼替丁影响胃内pH值，从而可能导致药物的吸收增加（例如三唑仑，咪达唑仑，格列吡嗪）或吸收减少（例如酮康唑，阿扎那韦，地拉夫定，吉非替尼）
雷贝拉唑	酮康唑	药效降低	正常受试者同时服用雷贝拉唑钠结果导致酮康唑水平下降33%，地高辛水平升高22%
替诺福韦	苯巴比妥	药效降低	预期诱导P-gp活性的药品（例如利福平、利福布丁、卡马西平、苯巴比妥）会降低丙酚替诺福韦的吸收，导致丙酚替诺福韦的血浆浓度下降，进而可能导致恩曲他滨丙酚替诺福韦疗效丧失并产生耐药性
阿莫西林克拉维酸	阿司匹林	药效提高，不良反应增加	．阿司匹林、吲哚美辛、保泰松、磺胺药可减少阿莫西林克拉维酸在肾小管的排泄，因而使阿莫西林克拉维酸的血药浓度升高，血消除半衰期（t1/2β）延长，毒性也可能增加
盐酸氨溴索口腔崩解片	抗生素	药效提高	盐酸氨溴索口腔崩解片与抗生素（阿莫西林、头孢呋新、红霉素、强力霉素）同时服用，可导致抗生素在肺组织浓度升高
注射用头孢地秦钠	顺铂	不良反应增加	注射用头孢地秦钠可加强具有潜在肾毒性药物的毒性作用，如与氨基甙类、两性霉素B、环孢素、顺铂、万古霉素、多粘菌素B或粘菌素同时或先后使用时，应密切监测肾功能
阿莫西林克拉维酸	吲哚美辛	药效提高，不良反应增加	阿司匹林、吲哚美辛、保泰松、磺胺药可减少阿莫西林克拉维酸在肾小管的排泄，因而使阿莫西林克拉维酸的血药浓度升高，血消除半衰期(t1/2β)延长，毒性也可能增加
卡马西平	奎尼丁	药效降低	与含雌激素的避孕药、环孢素、洋地黄类（可能地高辛除外）、雌激素、左旋甲状腺素或奎尼丁合用时，由于卡马西平对肝代谢酶的正诱导，这些药的效应都会降低，用量应作调整，改用仅含孕激素（黄体酮）的口服避孕药
硝酸异山梨酯注射液	肾上腺素	药效提高	合并服用具有降低血压作用的药物，例如血管舒张药、降压药(如β-肾上腺素受体阻滞剂、利尿剂、钙通道阻滞剂、ACE抑制剂)、神经松弛剂或三环类抗抑郁药以及酒精，可能会增强硝酸异山梨酯注射液的降压作用
洛匹那韦/利托那韦口服溶液	左吡登	不良反应增加	阿普唑仑、安非他酮、胺碘酮、阿咪唑、苄替地尔、西沙必利、氯拉折帕、氯氮平、右丙氧芬、地西泮、二氢麦角胺、恩卡肢、舒乐安定、麦角胺、氟卡胺、氟西泮、咪达唑仑、哌替啶、匹莫齐特、吡罗昔康、普罗帕酮、奎尼丁、利福布丁、特非那定、三唑仑和左吡登禁止用于洛匹那韦/利托那韦口服溶液治疗的病人，因为它们可能与洛匹那韦/利托那韦口服溶液发生相互作用，产生严重并发症的危险
阿莫西林克拉维酸钾干混悬剂	四环素	药效降低	一些药品，比如氯霉素，红霉素或四环素与阿莫西林克拉维酸钾干混悬剂合用，可减弱弱阿莫西林杀菌作用
尼罗替尼	酮康唑	药效提高	在健康受试者中，当与CYP3A4强抑制剂酮康唑合用时，尼罗替尼的生物利用度增加了3倍
米非司酮	苯巴比妥	药效降低	此外利福平、地塞米松、S.John’麦芽汁和某些抗惊厥药(苯妥英、苯巴比妥、卡马西平)可能诱导米非司酮代谢(降低米非司酮血清水平)
美洛昔康片	消胆胺	药效降低	在胃肠中消胆胺与美洛昔康片结合可加快美洛昔康片的排除
利多卡因Ⅰ	两性霉素B	药效降低，不良反应增加	与西咪替丁以及β受体阻断剂如，普萘洛尔、美托洛尔、纳多洛尔合用，利多卡因经肝脏代谢受抑制，利多卡因血浓度增加，可发生心脏和神经系统不良反应，应调整利多卡因剂量，并应心电图监护及监测利多卡因血药浓度；(2)巴比妥类药物可促进利多卡因代谢，两药合用可引起心动过缓，窦性停搏；(3)与普鲁卡因胺合用，可产生一过性谵妄及幻觉，但不影响利多卡因Ⅰ血药浓度；(4)异丙基肾上腺素因增加肝血流量，可使利多卡因Ⅰ的总清除率升高；去甲肾上腺素因减少肝血流量，可使利多卡因Ⅰ总清除率下降；(5)与下列药品有配伍禁忌：苯巴比妥，硫喷妥钠，硝普钠，甘露醇，两性霉素B，氨苄西林，磺胺嘧啶
环磷酰胺	别嘌呤醇	不良反应增加	如果环磷酰胺与别嘌呤醇或双氢克尿噻同时给药则可能加重骨髓抑制
复方溴丙胺太林	抗胆碱药	药效提高	复方溴丙胺太林可增强金刚烷胺、抗胆碱药、氟哌啶醇、吩噻嗪类以及拟交感神经药等的作用
波生坦片	他汀类药物	药效降低	辛伐他汀和其它他汀类药物：合用波生坦片125mg、每日2次，5日后辛伐他汀（CYP3A4底物）及其b-羟基酸活性代谢产物的血浆浓度分别降低34%和46%
异丙嗪胆汁片	巴比妥类	药效提高	醇或其他中枢神经抑制剂，特别是麻醉药、巴比妥类、单胺氧化酶抑制剂或三环类抗抑郁药与异丙嗪胆汁片同服时，可增强盐酸异丙嗪或(和)这些药物的效应
文拉法辛	美托洛尔	药效降低	在该研究中,文拉法辛似乎减弱了美托洛尔在健康志愿者中的作用，而降低了血压
醋硝香豆素片	阿司匹林	药效提高	能与醋硝香豆素片竞争血浆蛋白结合，使游离的双香豆乙酯增多，如阿司匹林、保泰松、羟基保泰松、甲芬那酸、水合氯醛、氯贝丁酯(安妥明)、磺胺类药、丙磺舒等
青霉素V钾干混悬剂	四环素类	药效降低	氯霉素、红霉素、四环素类等抗生素和磺胺药等抑菌药可干扰青霉素V钾干混悬剂的杀菌活性，因此不宜与青霉素V钾干混悬剂合用，尤其在治疗脑膜炎或急需杀菌药的严重感染时
左奥硝唑	萘夫西林	药效降低，不良反应增加	文献报道，奥硝唑与呋布西林钠、萘夫西林钠、奥美拉唑、沃必唑、注射用炎琥宁、阿洛西林钠存在配伍禁忌，左奥硝唑在使用时也应注意
维C橙皮苷颗粒	肝素	药效降低	维C橙皮苷颗粒与肝素或华法林联用，可引起凝血时间缩短
依诺沙星	华法林	药效提高，不良反应增加	依诺沙星与抗凝药华法林合用时可增强后者的抗凝作用，故应避免二者合用
注射用埃索美拉唑钠	西酞普兰	药效提高	CYP2C19是埃索美拉唑的主要代谢酶，故当注射用埃索美拉唑钠与经CYP2C19代谢的药物(如地西泮、西酞普兰、丙米嗪、氯米帕明、苯妥英等)合用时，这些药物的血浆浓度可被升高，可能需要降低剂量
沙格列汀	氟康唑	药效提高	应用其他中度CYP3A4/5抑制剂（如安普那韦、阿瑞匹坦、红霉素、氟康唑、呋山那韦、西柚汁和维拉帕米）也如预期所料提高了沙格列汀的血浆药物浓度
替尼泊苷	苯妥英	药效降低	苯巴比妥和苯妥英可以增加替尼泊苷的清除，合并用药时可能应增加替尼
酮康唑	苯丙胺	不良反应增加	-由于酮康唑与CYP3A4底物合用会增加这些药物的血浆浓度，而可能导致QT间期延长和个别出现尖端扭转型室速，因此酮康唑禁止与下列药物合用：特非那丁、苄普地尔、阿司咪唑、卤泛群、左醋美沙朵(左美沙酮)、咪唑斯汀、西沙必利、多非利特、奎尼丁、匹莫齐特、苯丙胺、舍吲哚；
甲氨蝶呤	门冬酰胺酶	药效降低	有报道使用门冬酰胺酶后拮抗甲氨蝶呤的疗效
牛磺酸	激素	药效提高	磺酸可增强脂溶性维生素、激素的吸收
维生素A	硫糖铝	药效降低	考来烯胺(colestyramine)、矿物油、新霉素、硫糖铝能干扰维生素A吸收
肌苷氯化钠注射液	盐酸去甲肾上腺素	药效降低，不良反应增加	肌苷氯化钠注射液禁与下列注射液配伍：乳清酸、氯霉素、双嘧达莫、盐酸山梗菜碱、硫酸阿托品、氢溴酸东莨菪碱、盐酸氯丙嗪、盐酸异丙嗪、马来酸麦角新碱、盐酸普鲁卡因、硫喷妥钠、苯妥英钠、氯氮卓、盐酸去甲肾上腺素、盐酸丁卡因、利血平、硝普钠、降压嗪、呋噻米、利尿酸钠、促皮质素、维生素B12、盐酸苯海拉明、马来酸氯苯那敏、细胞色素C、盐酸万古霉素、盐酸四环素、二盐酸奎宁、盐酸阿糖胞苷、硫酸长春新碱以及所有菌苗和疫苗
盐酸罗匹尼罗缓释片	酚噻嗪类	药效降低	由于罗匹尼罗是一种多巴胺激动剂，多巴胺拮抗剂如精神安定类药（酚噻嗪类、苯丁酮类和硫杂蒽类）或甲氧氯普胺可降低盐酸罗匹尼罗缓释片的疗效
利福布汀	印地那韦	药效提高	逆转录病毒抑制剂如地拉夫定、印地那韦、奈非那韦、利托那韦等与利福布汀联合用药时均存在相互作用，这些药物会增加利福布汀的血药浓度，如合并用药，应注意调整利福布汀剂量
复方双嗪利血平	三环类抗抑郁药	不良反应增加	与其他降压药同用时剂量需调整；2.与洋地黄类或奎尼丁同用，大剂量使用可引起心律失常；3.与三环类抗抑郁药合用，可减弱复方双嗪利血平的降压作用
复方地巴唑氢氯噻嗪	伊曲康唑	药效提高，不良反应增加	复方地巴唑氢氯噻嗪与抗真菌药酮康唑、伊曲康唑合用，可提高复方地巴唑氢氯噻嗪疗效并增加其毒性
依托红霉素	二羟丙茶碱	药效提高，不良反应增加	5.除二羟丙茶碱外，依托红霉素与黄嘌呤类合用可使氨茶碱的肝清除减少，导致血清氨茶碱浓度升高和（或）毒性反应增加
洛伐他汀颗粒	吉非罗齐	不良反应增加	洛伐他汀颗粒与免疫抑制剂如环孢素、阿奇霉素、克拉霉素、红霉素、达那唑、伊曲康唑、吉非罗齐、烟酸等合用可增加肌溶解和急性肾功能衰竭发生的危险
司帕沙星	硫糖铝	药效降低	司帕沙星与含有铝、镁、铁的抗酸药和硫糖铝合用时，可降低司帕沙星的吸收，从而降低药效，如需服用应间隔4小时
哌嗪	氯丙嗪	不良反应增加	哌嗪与氯丙嗪同用有可能引起抽搐，应避免合用
珠氯噻醇癸酸酯注射液	酒精	药效提高	珠氯噻醇癸酸酯注射液可增加酒精、巴比妥及其它中枢抑制药物的作用
环孢素软胶囊	氟伏沙明	药效提高	提高环孢素软胶囊血浆或全血浓度的药品有：酮康唑、氟康唑、伊曲康唑、红霉素、交沙霉素、克拉霉素等大环内酯类抗生素，强力霉素、口服避孕药、普罗帕酮以及地尔硫卓、尼卡地平、维拉帕米等钙拮抗剂，氟伏沙明、乙酰唑胺、甲氧氯普胺、达那唑、甲泼尼龙（高剂量）、别嘌醇、胺碘酮、胆酸及其衍生物、蛋白酶抑制剂
对乙酰氨基酚泡腾颗粒	氯霉素	不良反应增加	对乙酰氨基酚泡腾颗粒与氯霉素同服，可增强后者的毒性
西咪替丁	甲氧氯普胺	药效降低	甲氧氯普胺(胃复安)与西咪替丁同时服用，可使西咪替丁的血药浓度降低，西咪替丁的剂量需适当增加
美托洛尔	利福平	药效降低	利福平：利福平可诱导美托洛尔的代谢，导致后者的血药浓度降低
阿莫西林克拉维酸	吲哚美辛	药效提高，不良反应增加	阿司匹林、吲哚美辛、保泰松、磺胺药可减少阿莫西林克拉维酸在肾小管的排泄，因而使阿莫西林克拉维酸的血药浓度升高，血消除半衰期（t1/2β）延长，毒性也可能增加
单硝酸异山梨酯	西地那非	药效提高，不良反应增加	和西地那非合用会加强单硝酸异山梨酯的降压作用(见禁忌)，这将导致危及生命的心血管并发症，所以正在接受单硝酸异山梨酯治疗的病人不可使用西地那非
头孢氨苄	考来烯胺	药效降低	与考来烯胺（消胆胺）合用时，可使头孢氨苄的平均血药浓度降低
奥硝唑	西咪替丁	药效降低，不良反应增加	巴比妥类药、雷尼替丁和西咪替丁等药物可使奥硝唑加速消除而降效并可影响凝血因此应禁忌合用
米多君	洋地黄	不良反应增加	不推荐同时使用洋地黄制剂，可加强因使用米多君发生的心动过缓和可能发生传导阻滞
苯丙胺	丙卡巴肼	不良反应增加	单胺氧化酶抑制药如呋喃唑酮、丙卡巴肼等能使苯丙胺的心肌兴奋和升压作用增强，出现头痛、心律失常、呕吐等，应避免合用
他克莫司	布洛芬	不良反应增加	两性霉素B和布洛芬与他克莫司合用增强肾脏毒性
洛伐他汀	烟酸	不良反应增加	洛伐他汀与免疫抑制剂如环孢素、阿奇霉素、克拉霉素、红霉素、达那唑、伊曲康唑、吉非罗齐、烟酸等合用可增加肌溶解急性肾功能衰竭发生的危险
注射用羧苄西林钠	肝素	不良反应增加	大剂量注射用羧苄西林钠与肝素等抗凝药、血栓溶解药、水杨酸制剂、苯磺唑酮或血小板聚集抑制药合用可增加出血危险
洛芬葡锌那敏	呋喃苯胺酸	药效降低	芬葡锌那敏与呋塞米(呋喃苯胺酸)同用时，后者的排钠和降压作用减弱;与抗高血压药同用时也降低后者的降压效果
双氢麦角毒碱	交沙霉素	药效提高，不良反应增加	与细胞色素P450抑制剂如大环内酯类抗生素（如红霉素、克林霉素、三乙酰竹桃霉素、螺旋霉素、交沙霉素），吡咯抗真菌剂（如酮康唑、伊曲康唑）、蛋白酶抑制剂（如力托那韦、茚地那韦）或甲腈咪胍联合用药时可增加双氢麦角毒碱的药物浓度，从而导致外周血管收缩，所以应避免使用
复方对乙酰氨基酚Ⅱ	苯巴比妥	不良反应增加	复方对乙酰氨基酚Ⅱ不应与含有酒精的饮料、巴比妥类(如苯巴比妥)、解痉药类(如颠茄)同服，因可造成肝损害
利多卡因Ⅱ	纳多洛尔	药效提高，不良反应增加	与西咪替丁以及b受体阻断剂如，普萘洛尔、美托洛尔、纳多洛尔合用，利多卡因经肝脏代谢受抑制，利多卡因血浓度增加，可发生心脏和神经系统不良反应，应调整利多卡因剂量，并应心电图监护及监测利多卡因血药浓度；（2）巴比妥类药物可促进利多卡因代谢，两药合用可引起心动过缓，窦性停搏；（3）与普鲁卡因胺合用，可产生一过性谵妄及幻觉，但不影响利多卡因Ⅱ血药浓度；（4）异丙基肾上腺素因增加肝血流量，可使利多卡因Ⅱ的总清除率升高；去甲肾上腺素因减少肝血流量，可使利多卡因Ⅱ总清除率下降；（5）与下列药品有配伍禁忌：苯巴比妥，硫喷妥钠，硝普钠，甘露醇，两性霉素B，氨苄西林，磺胺嘧啶
甲硝唑	苯巴比妥	药效降低	同时应用苯妥英钠、苯巴比妥等诱导肝微粒体酶的药物，可加强甲硝唑代谢，使血药浓度下降，而苯妥英钠排泄减慢
利福平滴眼液	地西泮	药效降低	利福平滴眼液与地西泮(安定)合用可增加后者的消除，使其血药浓度减低，故需调整剂量
碳酸钙维D3元素片(4)	四环素类	药效降低	碳酸钙维D3元素片(4)与苯妥英钠类及四环素类同用，二者吸收减低
酮洛芬	丙磺舒	药效提高，不良反应增加	酮洛芬不应与丙磺舒同用，因后者可明显降低酮洛芬肾脏清除率（降低66%）和蛋白结合率（降低28%），导致血药浓度增高，而有引起中毒的危险
瑞舒伐他汀	抗酸药	药效降低	抗酸药：同时给予瑞舒伐他汀和一种含氢氧化铝镁的抗酯药混悬液，可使瑞舒伐他汀的血浆浓度降低约50%
盐酸美他环素分散片	镁	药效降低	含钙、镁、铁等金属离子的药物，可与盐酸美他环素分散片形成不溶性络合物，使盐酸美他环素分散片口服后吸收减少
托拉塞米注射液	皮质类固醇	不良反应增加	托拉塞米注射液可加强盐和糖皮质类固醇和轻泻剂的钾消耗作用
索他洛尔	利血平	药效提高，不良反应增加	索他洛尔与利血平、胍乙啶及其它有β-受体阻滞作用的药物合用可降低交感神经张力，导致低血压和严重心动过缓，甚至昏厥
牡蛎碳酸钙片	苯妥英钠	药效降低	牡蛎碳酸钙片与苯妥英钠及四环素类同用，二者吸收减少
茶碱Ⅱ	环丙沙星	药效提高，不良反应增加	与克林霉素、林可霉素及某些大环内酯类（红霉素、罗红霉素、克拉霉素）、喹诺酮类抗菌药（伊诺沙星、环丙沙星）合用时，可降低茶碱Ⅱ在肝脏的清除率，使血药浓度升高，甚至出现毒性反应，应在给药前后调整茶碱Ⅱ的用量
头孢米诺	利尿剂	不良反应增加	本口与氨茶碱、磷酸吡哆醛配伍会降低效价或着色，故不得配伍；与呋喃硫胺、硫辛酸，氢化可的松琥珀酸钠及腺苷钴胺配伍后时间稍长会变色，故配伍后应尽快使用；与利尿剂呋(呋喃苯胺酸等)等合用有可能增加肾毒性，应谨慎使用，动物实验证实，头孢米诺影响酒精代谢，使血中乙醛浓度上升，显示双硫仑样作用，故用药期间或用药后应禁酒
奈韦拉平	美沙酮	不良反应增加	据报道同时应用美沙酮和奈韦拉平的患者曾出现戒断综合症
克拉霉素	西沙必利	药效提高，不良反应增加	西沙必利与克拉霉素合用会升高病人西沙必利血药浓度，导致Q-T间期延长，心律失常如室性心动过速、室颤和峰值扭转
米非司酮	伊曲康唑	药效提高	其代谢有可能被酮康唑、伊曲康唑、红霉素和葡萄柚汁抑制（增加血清米非司酮水平）》此外，利福平、地塞米松、S.John麦芽汁和某些抗惊厥药（苯妥英、苯巴比妥、卡马西平）可能诱导米非司酮代谢（降低米非司酮血清水平）根据体外抑制资料，联合给予米非司酮可以导致本身是CYP3A4底物的药物血清水平增加，由于米非司酮从体内消除减慢，这种相互作用可以从给药后体内时间延长观察到
阿立哌唑	卡马西平	药效降低	CYP3A4诱导剂（如卡马西平）将会引起阿立哌唑的清除率升高和血药浓度降低
妥布霉素滴眼液	头孢噻吩	不良反应增加	妥布霉素滴眼液与头孢噻吩合用可能增加肾毒性
头孢呋辛酯	丙磺舒	药效提高	5g单剂量头孢呋辛酯与1g丙磺舒同时服用后的血药峰浓度（平均14.8μg/ml）比不服丙磺舒的血药峰浓度（平均12.2μg/ml）高
复方对乙酰氨基酚Ⅱ	颠茄	不良反应增加	复方对乙酰氨基酚Ⅱ不应与含有酒精的饮料、巴比妥类（如苯巴比妥）、解痉药（如颠茄）同服，因可造成肝脏损害
脂肪乳注射液	新斯的明	不良反应增加	脂肪乳注射液和琥珀胆碱或新斯的明合用后，可能出现心动过缓或心跳骤停
青霉素	去甲肾上腺素	药效降低，不良反应增加	青霉素与氨基糖苷类、去甲肾上腺素、间羟胺、苯巴比妥、维生素B族、维生素C等药物存在配伍禁忌，不宜同瓶滴注
左旋氨氯地平	β-阻滞剂	药效提高，不良反应增加	β-阻滞剂：与左旋氨氯地平合用耐受性良好，但可引起过度低血压，罕见加重心力衰竭
维生素B6	异烟肼	不良反应增加	6．氯霉类、坏丝氨酸、乙硫异烟胺、盐酸肼酞嗪、免疫抑制剂包括肾上腺皮质激素、环磷酰胺、环孢素、异烟肼、青霉胺等药物可拮抗维生素B6或增加维生素B6经肾排泄，可引起贫血或周围神经炎
西咪替丁咀嚼片	地西泮	药效提高，不良反应增加	西咪替丁咀嚼片与硝西泮（硝基安定）、地西泮（安定）、茶碱、普萘洛尔（心得安）、苯妥英钠、阿司匹林等同用时，均可使这些药物的血药浓度升高，作用增强，出现不良反应，甚至是毒性反应，故西咪替丁咀嚼片不宜与这些药物同用
他扎罗汀倍他米松	四环素类	不良反应增加	因他扎罗汀可增加光敏性，故如患者正在服用具有光敏性的药物（如：四环素类、氟喹诺酮类、酚噻嗪类、磺胺类药物等）时，应慎用他扎罗汀倍他米松
格列齐特Ⅱ	乙醇	不良反应增加	服用格列齐特Ⅱ后饮酒，使乙醇在肝脏被酶分解，使乙醇代谢停止于醛的阶段，而使醛蓄积，可出现戒酒硫(disulfiram)样作用
注射用抑肽酶	卡托普利	药效降低	注射用抑肽酶可抑制血管紧张素转换酶抑制剂（如卡托普利）的降压作用（曾有报道，但尚无结论性意见）
舒他西林	丙磺舒	药效提高，不良反应增加	丙磺舒、阿司匹林、吲哚美辛、保泰松、磺胺药可减少舒他西林在肾小管的排泄，因而使舒他西林的血药浓度升高，血消除半衰期（t1/2β）延长，毒性也可能增加
阿奇霉素	那非那韦	药效提高	药物相互作用：那非那韦稳态时，联合使用单剂量阿奇霉素口服，可使阿奇霉素血清浓度升高
他达拉非	伊曲康唑	药效提高	尽管未对特定的相互作用进行研究，其他CYP3A4抑制剂，如红霉素，伊曲康唑和葡萄柚果汁，也可能会增加他达拉非的暴露水平
棕榈氯霉素	阿芬他尼	药效提高	如在术前或术中应用，由于棕榈氯霉素对肝酶的抑制作用，可降低诱导麻醉药阿芬他尼的清除，延长其作用时间
对乙酰氨基酚	颠茄	不良反应增加	应用巴比妥类（如苯巴比妥）或解痉药（如颠茄）的患者，长期应用对乙酰氨基酚可致肝脏损害
罗替高汀	左旋多巴	不良反应增加	与其他多巴胺受体激动剂一样，罗替高汀可能加重左旋多巴的多巴胺能不良反应，并可能引发和/或加重已知运动障碍
西咪替丁	表柔比星	不良反应增加	不明的作用机理：西咪替丁可增强化疗药如：卡莫司汀、氟尿嘧啶，表柔比星或治疗如放射疗法的骨髓抑制作用（如：中性
氨氯地平	伊曲康唑	药效提高	但是，CYP3A4的强抑制剂（例如酮康唑，伊曲康唑，利托那韦）可能比地尔硫卓更能升高氨氯地平血浆浓度
哌拉西林	妥布霉素	药效降低	哌拉西林／他唑巴坦与妥布霉素同时使用时，妥布霉素的曲线下面积、肾清除率以及尿液中检出的妥布霉素分别减少了11%、32%和38%，与哌拉西林／他唑巴坦联合应用后，妥布霉素的药动学发生改变的原因是因为哌拉西林/他唑巴坦的存在致使妥布霉素的失活造成的
阿奇霉素	抗凝剂	药效提高	有报道同时应用阿奇霉素和香豆素类口服抗凝剂可使抗凝作用增强
舒巴坦	复方乳酸钠注射液	药效降低，不良反应增加	舒巴坦与复方乳酸钠注射液或盐酸利多卡因注射液混合后出现配伍禁忌
辛伐他汀	酮康唑	不良反应增加	当辛伐他汀与其他在治疗剂量下对细胞色素P4503A4有明显抑制作用的药物（如：环孢霉素、米贝地尔、伊曲康唑、酮康唑、红霉素、克拉霉素和奈法唑酮）或纤维酸类衍生物或烟酸合用时，导致横纹肌溶解的危险性增高
苯唑西林	维生素C	药效降低，不良反应增加	苯唑西林与氨基糖苷类、去甲肾上腺素、间羟胺、苯巴比妥、维生素B族、维生素C等药物存在配伍禁忌，不宜同瓶滴注
氨溴索	红霉素	药效提高	氨溴索与抗生素协同治疗(阿莫西林、头孢呋辛、红霉素、强力霉素)可导致抗生素在肺组织浓度升高
莫达非尼	酮康唑	药效降低	此外，由于莫达非尼的代谢消除部分与CYP3A4有关，与CYP3A4的强诱导剂（例如，卡马西平、苯巴比妥、利福平）或者强抑制剂（例如，酮康唑、伊曲康唑）合用会改变莫达非尼的血药浓度
更昔洛韦	长春花碱	不良反应增加	抑制高分裂相细胞(骨髓、精原细胞、皮肤和胃肠道粘膜生发层)复制的药物(氨苯砜、喷他脒、氟胞嘧啶、长春新碱、长春花碱、阿霉素、两性霉素B、甲氧苄啶/磺胺恶唑或其他核苷类)与更昔洛韦合用时毒性增加
维生素C	乙醇	药效降低	4．长期或大量应用维生素C时，能干扰双硫仑对乙醇的作用
精氨酸阿司匹林	口服降糖药	药效提高	胰岛素或口服降糖药物的降糖效果可因与精氨酸阿司匹林同用而加强和加速
利福平	异烟肼	不良反应增加	异烟肼与利福平或咪康唑(静脉)、酮康唑合用可增加肝毒性发生的危险，尤其是原有肝功能损害者和异烟肼快乙酰化患者
卡维地洛	钙通道阻滞剂	不良反应增加	卡维地洛与地尔硫卓联合口服时，个别病人出现心脏传导障碍（对血流动力学的影响罕见同其它具有β受体阻滞作用的药物一样，卡维地洛与维拉帕米及地尔硫卓等钙通道阻滞剂或I类抗心率失常药合用时，应严密监视病人的心电围和血压情况，并严禁静脉联合使用此类药物
硝酸异山梨酯注射液	三环类抗抑郁药	药效提高	合并服用具有降低血压作用的药物，例如血管舒张药、降压药(如β-肾上腺素受体阻滞剂、利尿剂、钙通道阻滞剂、ACE抑制剂)、神经松弛剂或三环类抗抑郁药以及酒精，可能会增强硝酸异山梨酯注射液的降压作用
茚地那韦	卡马西平	药效降低	对CYP3A4诱导作用弱于利福平的其他药物，如苯巴比妥、苯妥英、卡马西平和地塞米松，与茚地那韦合用时应谨慎，因为它们也可能降低茚地那韦的血浆浓度
氯化钠	酰胺类	药效降低	氯化钠与β-内酰胺类(头孢菌素类或青霉素)混合可导致相互失活，需联合应用时必须分瓶注射
利血平	三环类抗抑郁药	不良反应增加	与其他降压药同用时剂量需调整；2.与洋地黄类或奎尼丁同用，大剂量使用可引起心律失常；3.与三环类抗抑郁药合用，可减弱利血平的降压作用
氢氯噻嗪	噻嗪类利尿剂	药效提高，不良反应增加	维生素D：联合使用噻嗪类利尿剂（包括氢氯噻嗪）与维生素D或钙盐可引起血钙升高
利多卡因	甘露醇	药效提高，不良反应增加	与西咪替丁以及b受体阻断剂如，普萘洛尔、美托洛尔、纳多洛尔合用，利多卡因经肝脏代谢受抑制，利多卡因血浓度增加，可发生心脏和神经系统不良反应，应调整利多卡因剂量，并应心电图监护及监测利多卡因血药浓度；（2）巴比妥类药物可促进利多卡因代谢，两药合用可引起心动过缓，窦性停搏；（3）与普鲁卡因胺合用，可产生一过性谵妄及幻觉，但不影响利多卡因血药浓度；（4）异丙基肾上腺素因增加肝血流量，可使利多卡因的总清除率升高；去甲肾上腺素因减少肝血流量，可使利多卡因总清除率下降；（5）与下列药品有配伍禁忌：苯巴比妥，硫喷妥钠，硝普钠，甘露醇，两性霉素B，氨苄西林，磺胺嘧啶
丙戊酸	红霉素	药效提高	当与甲氰咪胍或红霉素同时应用时，血清丙戊酸水平可以增高(由于肝脏代谢降低的结果)
克拉霉素	丙吡胺	不良反应增加	上市报告中有联合应用克拉霉素和奎尼丁或丙吡胺后出现尖端扭转性室性心动过速的病例
阿咖	抗酸药	药效降低	抗酸药如碳酸氢钠等可增加阿咖自尿中的排泄，使血药浓度下降，不宜同用
罗红霉素	西沙必利	药效提高	西沙必利、匹莫齐特：两者均为肝细胞CYP3A同功酶代谢药物，可导致QT间期延长，不推荐罗红霉素与二者合用
替诺福韦	阿扎那韦	药效降低	富马酸替诺福韦二吡呋酯能够降低阿扎那韦的AUC和Cmin（参见【药代动力学】）
酚咖	苯巴比妥	不良反应增加	应用巴比妥类（如苯巴比妥）或解痉药（如颠茄）的患者，长期应用酚咖可致肝损害
非洛地平	利福平	药效降低	细胞色素P450诱导剂：通过诱导P450而增加非洛地平代谢的药物，如卡马西平、苯妥英、苯巴比妥、利福平和圣约翰草（hypericumperforatum），当非洛地平与卡马西平、苯妥英、苯巴比妥合用时，非洛地平的AUC降低93％，Cmax降低82％
单硝酸异山梨酯Ⅳ	西地那非	药效提高，不良反应增加	和治疗勃起机能障碍的西地那非合用会增加单硝酸异山梨酯Ⅳ的降压作用，可能引起致命的心血管并发症，因此使用单硝酸异山梨酯Ⅳ时不能使用西地那非
齐多夫定	更昔洛韦	不良反应增加	与具有潜在肾毒性或骨髓抑制作用的药物，如全身用喷他咪、氨苯砜、乙胺嘧啶、复方磺胺甲恶唑、两性霉素、氟胞嘧啶、更昔洛韦、干扰素、长春新碱、长春花碱及阿霉素同时应用，特别在急性期治疗时亦可以使齐多夫定产生不良反应的机率增加
氨氯地平	环孢素	药效提高	联合用药时，氨氯地平可能增加环孢素或他克莫司的全身暴露
盐酸利多卡因注射液(溶媒用)	普鲁卡因胺	不良反应增加	与普鲁卡因胺合用，可产生一过性谵妄及幻觉，但不影响盐酸利多卡因注射液(溶媒用)血药浓度
氯化钠	甲氨蝶呤	药效降低，不良反应增加	氯化钠与碱性注射液(如呋喃苯胺酸、甲氨蝶呤、氟尿嘧啶、吡咯他尼注射液)或鬼臼乙叉甙注射液配伍会发生浑浊或结晶析出，应避免配伍使用
四环素	巴比妥类	药效降低	由于巴比妥类、苯妥英或卡马西平可诱导微粒体酶的活性致使四环素血药浓度降低，故合用时须调整四环素的剂量
氯胺酮	拟交感神经药	不良反应增加	甲状腺激素、直接或间接作用的拟交感神经药和血管加压素与氯胺酮合用可能导致血压升高（高血压）和心率加速（心动过速）
细辛脑片	青霉素	药效提高	细辛脑片与青霉素、庆大霉素、红霉素等联用可增加疗效
酮康唑	左醋美沙朵(左美沙酮)	不良反应增加	-由于酮康唑与CYP3A4底物合用会增加这些药物的血浆浓度，而可能导致QT间期延长和个别出现尖端扭转型室速，因此酮康唑禁止与下列药物合用：特非那丁、苄普地尔、阿司咪唑、卤泛群、左醋美沙朵(左美沙酮)、咪唑斯汀、西沙必利、多非利特、奎尼丁、匹莫齐特、苯丙胺、舍吲哚；
氨茶碱氯化钠	环丙沙星	药效提高，不良反应增加	与克林霉素、林可霉素及某些大环内酯类(红霉素、罗红霉素、克拉霉素)、喹诺酮类抗菌药(伊诺沙星、环丙沙星)合用时，可降低氨茶碱氯化钠在肝脏的清除率，使血药浓度升高，甚至出现毒性反应，应在给药时调整氨茶碱氯化钠的用量
利多卡因	纳多洛尔	药效提高，不良反应增加	与西咪替丁以及β受体阻断剂如，普萘洛尔、美托洛尔、纳多洛尔合用，利多卡因经肝脏代谢受抑制，利多卡因血浓度增加，可发生心脏和神经系统不良反应，应调整利多卡因剂量，并应心电图监护及监测利多卡因血药浓度；
妥布霉素	头孢菌素类	药效降低	妥布霉素与β内酰胺类(头孢菌素类或青霉素类)混合可导致相互失活，需联合应用时必须分瓶注射
茶碱Ⅱ	林可霉素	药效提高，不良反应增加	与克林霉素、林可霉素及某些大环内酯类(红霉素、罗红霉素、克拉霉素)、喹诺酮类抗菌药(伊诺沙星、环丙沙星)合用时，可降低茶碱Ⅱ在肝脏的清除率，使血药浓度升高，甚至出现毒性反应，应在给药时调整茶碱Ⅱ的用量
普萘洛尔	齐留通	药效提高，不良反应增加	与CYP1A2酶底物或抑制剂合用，例如丙咪嗪、西咪替丁、环丙沙星、伏沙明、异烟肼、利托那韦、茶碱、齐留通、佐米曲普坦和利扎曲坦，可增加普萘洛尔的血浓度和/或毒性
桂利嗪	苯妥英钠	药效降低	与苯妥英钠、卡马西平联合应用时，可以降低氟桂利嗪的血药浓度
利托那韦	三唑仑	不良反应增加	阿普唑仑、安非他酮、胺碘酮、阿咪唑、苄替地尔、西沙必利、氯拉折帕、氯氮平、右丙氧芬、地西泮、二氢麦角胺、恩卡肢、舒乐安定、麦角胺、氟卡胺、氟西泮、咪达唑仑、哌替啶、匹莫齐特、吡罗昔康、普罗帕酮、奎尼丁、利福布丁、特非那定、三唑仑和左吡登禁止用于利托那韦治疗的病人，因为它们可能与利托那韦发生相互作用，产生严重并发症的危险
青霉素	苯唑西林	药效提高	丙磺舒可减少苯唑西林的肾小管分泌，延长青霉素的血清半衰期
利托那韦口服溶液	舒乐安定	不良反应增加	阿普唑仑、安非他酮、胺碘酮、阿咪唑、苄替地尔、西沙必利、氯拉折帕、氯氮平、右丙氧芬、地西泮、二氢麦角胺、恩卡肢、舒乐安定、麦角胺、氟卡胺、氟西泮、咪达唑仑、哌替啶、匹莫齐特、吡罗昔康、普罗帕酮、奎尼丁、利福布丁、特非那定、三唑仑和左吡登禁止用于利托那韦口服溶液治疗的病人，因为它们可能与利托那韦口服溶液发生相互作用，产生严重并发症的危险
西咪替丁咀嚼片	苯妥英钠	药效提高，不良反应增加	西咪替丁咀嚼片与硝西泮（硝基安定）、地西泮（安定）、茶碱、普萘洛尔（心得安）、苯妥英钠、阿司匹林等同用时，均可使这些药物的血药浓度升高，作用增强，出现不良反应，甚至是毒性反应，故西咪替丁咀嚼片不宜与这些药物同用
注射用头孢地嗪钠	两性霉素B	不良反应增加	注射用头孢地嗪钠可加强具有潜在肾毒性药物的毒性作用，如与氨基糖苷类、两性霉素B、环孢素、顺铂、万古霉素、多粘菌素B或粘菌素同时或先后使用时，应密切监测肾功能
他唑巴坦	氨基糖苷类抗生素	药效降低，不良反应增加	但他唑巴坦与氨基糖苷类抗生素之间存在着物理性配伍禁忌，因此两种药液不能直接混合
多维铁口服溶液	甲基多巴	药效降低	多维铁口服溶液可减少左旋多巴、卡比多巴、甲基多巴及喹诺酮类药物的吸收
利福霉素	抗肿瘤药	药效降低，不良反应增加	利福霉素可诱导肝微粒体酶，增加抗肿瘤药达卡巴嗪(dacarbazine)、环磷酰胺的代谢，形成烷化代谢物，促使白细胞减低，因此需调整剂量
普鲁卡因胺	酒精	不良反应增加	降压药合用，尤其静注普鲁卡因胺时，降压作用可增强；④与拟胆碱药合用时，普鲁卡因胺可抑制这类药对横纹肌的效应；⑤与神经肌肉阻滞剂（包括去极化型和非去极化型阻滞剂）合用时，神经肌肉接头的阻滞作用增强，时效延长；⑥酒精可以增加该药的清除率，缩短其半衰期；⑦抗酸药物可以降低其生物利用度，因此不建议两者合用；⑧西咪替丁可以降低普鲁卡因胺和N-乙酰普鲁卡因胺的肾清除率，因此两药合用时需减低普鲁卡因胺的用量；⑨雷尼替丁可影响该药在肾脏的代谢，合用时注意调整用量；⑩甲氧苄啶可以降低普鲁卡因胺和N-乙酰普鲁卡因胺的肾清除率，合用时需减低普鲁卡因胺的用量
西咪替丁	卡莫司汀	不良反应增加	不明的作用机理：西咪替丁可增强化疗药如：卡莫司汀、氟尿嘧啶，表柔比星或治疗如放射疗法的骨髓抑制作用（如：中性
头孢米诺	酒精	不良反应增加	本口与氨茶碱、磷酸吡哆醛配伍会降低效价或着色，故不得配伍；与呋喃硫胺、硫辛酸，氢化可的松琥珀酸钠及腺苷钴胺配伍后时间稍长会变色，故配伍后应尽快使用；与利尿剂呋(呋喃苯胺酸等)等合用有可能增加肾毒性，应谨慎使用，动物实验证实，头孢米诺影响酒精代谢，使血中乙醛浓度上升，显示双硫仑样作用，故用药期间或用药后应禁酒
普鲁卡因胺	雷尼替丁	药效提高	降压药合用，尤其静注普鲁卡因胺时，降压作用可增强；④与拟胆碱药合用时，普鲁卡因胺可抑制这类药对横纹肌的效应；⑤与神经肌肉阻滞剂（包括去极化型和非去极化型阻滞剂）合用时，神经肌肉接头的阻滞作用增强，时效延长；⑥酒精可以增加该药的清除率，缩短其半衰期；⑦抗酸药物可以降低其生物利用度，因此不建议两者合用；⑧西咪替丁可以降低普鲁卡因胺和N-乙酰普鲁卡因胺的肾清除率，因此两药合用时需减低普鲁卡因胺的用量；⑨雷尼替丁可影响该药在肾脏的代谢，合用时注意调整用量；⑩甲氧苄啶可以降低普鲁卡因胺和N-乙酰普鲁卡因胺的肾清除率，合用时需减低普鲁卡因胺的用量
异卡波肼	美芬丁胺	药效提高	异卡波肼与间羟胺、甲氧明、美芬丁胺合用，均可显著增强升压效应
文拉法辛	利奈唑胺	不良反应增加	类似其它5-羟色胺能药物，使用文拉法辛治疗时，可能发生5-羟色胺综合征（一种有潜在生命威胁的情况），尤其是在与以下药物合并使用时：其它作用于5-羟色胺递质系统的药物（包括曲坦、SSRIs、其它SNRIs、锂盐、西布曲明、曲马多或圣约翰草[金丝桃属植物提取物]），损害5-羟色胺代谢的药物（如MAOIs，包括利奈唑胺[一种抗生素，是可逆性、非选择性的MAOI]和亚甲蓝）或5-羟色胺前体（如：色氨酸补充剂）（见[禁忌]和[注意事项]）
异丙托溴铵	黄嘌呤类制剂	药效提高	使用β-肾上腺素能兴奋剂或黄嘌呤类制剂(如茶碱)可加强异丙托溴铵的作用
瑞舒伐他汀	维生素K拮抗剂	不良反应增加	维生素K拮抗剂：同其它HMG-CoA还原酶抑制剂一样，对同时使用维生素K拮抗剂（如：华法林）的患者，开始使用瑞舒伐他汀或逐渐增加瑞舒伐他汀剂量可能导致INR升高
左旋多巴	苯妥英	药效降低，不良反应增加	有报道苯妥英和罂粟碱可逆转左旋多巴对帕金森氏病的疗效
双氯芬酸钠缓释胶囊(Ⅲ)	维拉帕米	药效提高	与维拉帕米、硝苯地平同用时，双氯芬酸钠缓释胶囊(Ⅲ)的血药浓度增高
氨溴索	阿莫西林	药效提高	氨溴索与抗生素(阿莫西林、头孢呋辛、红霉素、强力霉素)协同治疗可升高抗生素在肺组织浓度
氯霉素	阿芬他尼	药效提高	氯霉素如在术前或术中应用时，由于其对肝酶的抑制作用，可降低诱导麻醉药阿芬他尼的清除，延长其作用时间
复方芦荟维U	左旋多巴	药效提高	复方芦荟维U与左旋多巴合用时，后者吸收可能增加
更昔洛韦	喷他脒	不良反应增加	抑制高分裂相细胞(骨髓、精原细胞、皮肤和胃肠道粘膜生发层)复制的药物(氨苯砜、喷他脒、氟胞嘧啶、长春新碱、长春花碱、阿霉素、两性霉素B、甲氧苄啶/磺胺恶唑或其他核苷类)与更昔洛韦合用时毒性增加
氨氯地平	地尔硫卓	药效提高	但是，CYP3A4的强抑制剂（例如酮康唑，伊曲康唑）可能比地尔硫卓更能升高氨氯地平血浆浓度，因此当氨氯地平与CYP3A4抑制剂合并给药时应谨慎
肝素	尿激酶	药效提高，不良反应增加	（l）肝素与下列药物合用，可加重出血危险：①香豆素及其衍生物，可导致严重的因子Ⅸ缺乏而致出血；②阿司匹林及非甾体消炎镇痛药，包括甲芬那酸、水杨酸等均能抑制血小板功能，并能诱发胃肠道溃疡出血；③双嘧达莫、右旋糖酐等可能抑制血小板功能；④肾上腺皮质激素、促肾上腺皮质激素等易诱发胃肠道溃疡出血；⑤其他尚有利尿酸、组织纤溶酶原激活物（t-PA）、尿激酶、链激酶等
异丙嗪胆汁	降压药	药效提高	苄铵、异喹胍或胍乙啶等降压药与异丙嗪胆汁同用时，前者的降压效应增强
维U颠茄铝Ⅱ	左旋多巴	药效提高	维U颠茄铝Ⅱ与左旋多巴合用时，吸收可能增加，胃排空缓慢者尤其明显
丙戊酸	苯巴比妥	药效提高，不良反应增加	苯巴比妥：丙戊酸增加苯巴比妥的血药浓度（由于抑制了肝脏分解代谢），导致镇静作用，尤其是儿童
咪达普利	氢氯噻嗪	药效提高	使用利尿剂(三氯甲噻嗪、双氢氯噻嗪等)治疗的患者，初次服用咪达普利会使降压效果增强
苯海索	抗胆碱药	药效提高，不良反应增加	苯海索与金刚烷胺、抗胆碱药、单胺氧化酶抑制药帕吉林及丙卡巴肼合用时，可加强抗胆碱作用，并可发生麻痹性肠梗阻
非诺贝特	磺脲类	药效提高	非诺贝特与其它高蛋白结合率的药物合用时，可使它们的游离型增加，药效增强，如甲苯磺丁脲及其它磺脲类降糖药、苯妥英、呋塞米等，在降血脂治疗期间服用上述药物，则应调整降糖药及其它药的剂量
克拉维酸钾	保泰松	药效提高，不良反应增加	阿司匹林、吲哚美辛、保泰松、磺胺药、丙磺舒可减少克拉维酸钾在肾小管的排泄，因而可使克拉维酸钾的血药浓度升高，而且维持较久，血消半衰期延长，毒性也可能增加
小儿氨咖黄敏	苯巴比妥	不良反应增加	l.应用巴比妥类(如苯巴比妥)或解痉药(如颠茄)的患者，长期使用小儿氨咖黄敏时可致肝脏损害
吉非罗齐	环孢素	药效提高，不良反应增加	吉非罗齐主要经肾排泄，在免疫抑制剂，如环孢素合用时，可增加后者的血药浓度和肾毒性，有导致肾功能恶化的危险，应减量或停药
小诺霉素	呋喃妥因	药效降低，不良反应增加	小诺霉素不宜与两性霉素B、头孢噻吩钠、呋喃妥因钠、磺胺嘧啶钠和盐酸四环素等（以上均为注射液）联合应用，因可发生配伍禁忌
氧	苯妥英	药效提高	氧可干扰苯妥英的肝内代谢，增加苯妥英的半衰期(t1/2)达50%，并使其清除率降低
利多卡因Ⅰ	纳多洛尔	药效提高，不良反应增加	与西咪替丁以及b受体阻断剂如，普萘洛尔、美托洛尔、纳多洛尔合用，利多卡因经肝脏代谢受抑制，利多卡因血浓度增加，可发生心脏和神经系统不良反应，应调整利多卡因剂量，并应心电图监护及监测利多卡因血药浓度；（2）巴比妥类药物可促进利多卡因代谢，两药合用可引起心动过缓，窦性停搏；（3）与普鲁卡因胺合用，可产生一过性谵妄及幻觉，但不影响利多卡因Ⅰ血药浓度；（4）异丙基肾上腺素因增加肝血流量，可使利多卡因Ⅰ的总清除率升高；去甲肾上腺素因减少肝血流量，可使利多卡因Ⅰ总清除率下降；（5）与下列药品有配伍禁忌：苯巴比妥，硫喷妥钠，硝普钠，甘露醇，两性霉素B，氨苄西林，磺胺嘧啶
复方地巴唑氢氯噻嗪	酮康唑	药效提高，不良反应增加	复方地巴唑氢氯噻嗪与抗真菌药酮康唑、伊曲康唑合用，可提高复方地巴唑氢氯噻嗪疗效并增加其毒性
单硝酸异山梨酯缓释片	β-受体阻滞剂	药效提高	同时服用具降血压作用的药物，如β-受体阻滞剂、钙通道阻滞剂、血管扩张药和/或酒精、精神安定剂、三环类抗抑郁药可增强单硝酸异山梨酯缓释片的降血压作用
头孢克洛	丙磺舒	药效提高	口服丙磺舒可延迟头孢克洛的排泄
颠茄片	普鲁卡因胺	不良反应增加	颠茄片与金刚烷胺、美克洛嗪、吩噻嗪类药（氯丙嗪、奋乃静）、阿托品类药、普鲁卡因胺、三环类抗抑郁药等同用时，颠茄片的不良反应可加剧
复方普萘洛尔咖啡因	保泰松	药效提高，不良反应增加	与抗凝剂如香豆素类或氯霉素、异烟肼、保泰松、磺胺类合用，可减低复方普萘洛尔咖啡因的代谢，可能增加复方普萘洛尔咖啡因的毒性
注射用硫酸小诺霉素	氨基糖苷类	不良反应增加	注射用硫酸小诺霉素与其他氨基糖苷类同用或先后连续局部或全身应用，可增加耳毒性、肾毒性以及神经肌肉阻滞作用
达比加群	利福平	药效提高	预计与P-gp诱导物（如：利福平、贯叶连翘（金丝桃）、卡马西平、或苯妥英等）联合使用会降低达比加群血药浓度，因此应该避免联合使用（参见【注意事项】和【药代动力学】）
舒巴坦	吲哚美辛	药效提高，不良反应增加	丙磺舒、阿司匹林、吲哚美辛、保泰松、磺胺药可减少舒巴坦自肾脏排泄，因此与舒巴坦合用时使其血药浓度增高，排泄时间延长，毒性也可能增加
维生素E	维生素A	药效提高	l.维生素E可促进维生素A的吸收、利用和肝脏贮存
双氯芬酸钾片	硝苯地平	药效提高	与维拉帕米、硝苯地平同用时，双氯芬酸钾片的血药浓度增高
阿莫西林克拉维酸	阿司匹林	药效提高，不良反应增加	阿司匹林、吲哚美辛、保泰松、磺胺药可减少阿莫西林克拉维酸在肾小管的排泄，因而使阿莫西林克拉维酸的血药浓度升高，血消除半衰期(t1/2β)延长，毒性也可能增加
普鲁卡因青霉素	丙磺舒	药效提高	丙磺舒、阿司匹林、吲哚美辛、保泰松和磺胺药减少青霉素的肾小管分泌而延长普鲁卡因青霉素的血清半衰期
氧	苯妥英	药效提高	氧可干扰苯妥英的肝内代谢，增加苯妥英的半衰期（t1/2)达50%，并使其清除率降低30%
诺氟沙星	茶碱类	药效提高，不良反应增加	诺氟沙星与茶碱类合用时可能由于与细胞色素P450结合部位的竞争性抑制，导致茶碱类的肝清除明显减少，血消除半衰期延长，血药浓度升高，出现茶碱中毒症状，如恶心、呕吐、震颤、不安、激动、抽搐、心悸等，故合用时应测定茶碱类的血药浓度和调整剂量
托拉塞米	卡那霉素	不良反应增加	可加强氨基糖甙类抗生素（如卡那霉素、庆大霉素、妥布霉素）、抑制细胞增殖的铂衍生物和头孢菌素的耳毒性和肾脏毒性效应，特别是大剂量托拉塞米治疗时；
哌拉西林	丙磺舒	药效提高	哌拉西林与丙磺舒合用，可以使哌拉西林半衰期延长21%，他唑巴坦半衰期延长71%
塞瑞替尼胶囊	酮康唑	药效提高	如果同时使用强效CYP3A抑制剂（包括但不限于利托那韦、沙奎那韦、泰利霉素、酮康唑、伊曲康唑、伏立康唑、泊沙康唑、奈法唑酮）无法避免，则应将塞瑞替尼胶囊的剂量减少约三分之一，并近似为150mg剂量规格的倍数
氯雷氨酚伪麻	氯霉素	药效提高，不良反应增加	与氯霉素合用，氯雷氨酚伪麻所含对乙酰氨基酚可延长氯霉素的半衰期，增强其毒性；
甲氨蝶呤	叶酸	不良反应增加	氨苯蝶啶、乙胺嘧啶等药物均有抗叶酸作用，如与甲氨蝶呤同用可增加其毒副作用；
替诺福韦	阿扎那韦	药效提高	已证明洛匹那韦/利托那韦、阿扎那韦与利托那韦联用以及地瑞那韦与利托那韦联用会使替诺福韦浓度增加（参见【药代动力学】）
地奈德	红霉素	药效提高，不良反应增加	当与其它已知的CYP3A4抑制剂(如伊曲康唑、克拉霉素、红霉素等)联合用药时，可能使布地奈德的代谢受到抑制，并且增加布地奈德的全身暴露量
曲美替尼	P-gp抑制剂	药效提高	由于不能排除强效抑制肝脏P-gp导致曲美替尼水平升高的可能性，建议曲美替尼应谨慎合用强效P-gp抑制剂（如维拉帕米、环孢菌素、利托那韦、奎尼丁和伊曲康唑）
阿莫西林	保泰松	药效提高，不良反应增加	阿司匹林、吲哚美辛、保泰松、磺胺药可减少阿莫西林在肾小管的排泄，因而使阿莫西林的血药浓度升高，血消除半衰期（t1/2b）延长，毒性也可能增加
瑞舒伐他汀	HMG-CoA还原酶抑制剂	不良反应增加	秋水仙碱：有报告包括瑞舒伐他汀在内的HMG-CoA还原酶抑制剂与秋水仙碱合用时发现包括横纹肌溶解在内的肌病，因此，瑞舒伐他汀与秋水仙碱合用要谨慎
青霉素	吲哚美辛	药效提高，不良反应增加	丙磺舒、阿司匹林、吲哚美辛、保泰松、磺胺药可减少青霉素在肾小管的排泄，使青霉素的血药浓度升高，血清半衰期延长，毒性也可能增加
胺碘酮	苯妥英	药效提高	胺碘酮可增高血浆中奎尼丁、普鲁卡因胺、氟卡尼及苯妥英的浓度
利托那韦口服溶液	吡罗昔康	不良反应增加	阿普唑仑、安非他酮、胺碘酮、阿咪唑、苄替地尔、西沙必利、氯拉折帕、氯氮平、右丙氧芬、地西泮、二氢麦角胺、恩卡肢、舒乐安定、麦角胺、氟卡胺、氟西泮、咪达唑仑、哌替啶、匹莫齐特、吡罗昔康、普罗帕酮、奎尼丁、利福布丁、特非那定、三唑仑和左吡登禁止用于利托那韦口服溶液治疗的病人，因为它们可能与利托那韦口服溶液发生相互作用，产生严重并发症的危险
阿托伐他汀	他汀类药物	不良反应增加	与其他他汀类药物一样，在合并使用阿托伐他汀和夫西地酸的上市后经验中，已有肌肉相关事件的报道，包括横纹肌溶解症
对乙酰氨基酚	颠茄	不良反应增加	应用巴比妥类(如苯巴比妥)或解痉药（如颠茄）的患者，长期应用对乙酰氨基酚可致肝损害
吲哚美辛沙丁胺醇	肝素	药效提高，不良反应增加	吲哚美辛沙丁胺醇与肝素、口服抗凝药合用时，使抗凝作用加强，因此有增加出血的危险
卡维地洛	地尔硫卓	不良反应增加	卡维地洛与地尔硫卓合用时，个别病人出现心脏传导障碍（对血流动力学的影响罕见）
阿莫西林克拉维酸钾	吲哚美辛	药效提高，不良反应增加	司匹林、吲哚美辛、保泰松、磺胺药可减少阿莫西林克拉维酸钾在肾小管的排泄，因而使阿莫西林克拉维酸钾的血药浓度升高，血消除半衰期（t1/2）延长，毒性也可能增加
氨苄西林	去甲肾上腺素	药效降低，不良反应增加	氨苄西林与氨基糖苷类、去甲肾上腺素、间羟胺、苯巴比妥、维生素B族、维生素C等药物存在配伍禁忌，不宜同瓶滴注
肝素	肾上腺皮质激素	药效提高，不良反应增加	（l）肝素与下列药物合用，可加重出血危险：①香豆素及其衍生物，可导致严重的因子Ⅸ缺乏而致出血；②阿司匹林及非甾体消炎镇痛药，包括甲芬那酸、水杨酸等均能抑制血小板功能，并能诱发胃肠道溃疡出血；③双嘧达莫、右旋糖酐等可能抑制血小板功能；④肾上腺皮质激素、促肾上腺皮质激素等易诱发胃肠道溃疡出血；⑤其他尚有利尿酸、组织纤溶酶原激活物（t-PA）、尿激酶、链激酶等
氨溴索	抗生素	药效提高	氨溴索与抗生素(阿莫西林、头孢呋辛、红霉素、强力霉素)协同治疗可升高抗生素在肺组织浓度
依非韦伦片	克拉霉素	不良反应增加	服用依非韦伦片和克拉霉素时，46%的未受感染的志愿者出现皮疹
缬沙坦氨氯地平片(Ⅰ)	利尿剂	不良反应增加	如果同时使用利尿剂，锂中毒的风险可能会随着缬沙坦氨氯地平片(Ⅰ)的使用进一步增加
对乙酰氨基酚	颠茄	不良反应增加	对乙酰氨基酚不应与含有酒精的饮料、巴比妥类(如苯巴比妥)、解痉药类(如颠茄)同服，因可造成肝损害
利多卡因Ⅱ	两性霉素B	药效提高，不良反应增加	与西咪替丁以及β受体阻断剂如，普萘洛尔、美托洛尔、纳多洛尔合用，利多卡因经肝脏代谢受抑制，利多卡因血浓度增加，可发生心脏和神经系统不良反应，应调整利多卡因剂量，并应心电图监护及监测利多卡因血药浓度；(2)巴比妥类药物可促进利多卡因代谢，两药合用可引起心动过缓，窦性停搏；(3)与普鲁卡因胺合用，可产生一过性谵妄及幻觉，但不影响利多卡因Ⅱ血药浓度；(4)异丙基肾上腺素因增加肝血流量，可使利多卡因Ⅱ的总清除率升高；去甲肾上腺素因减少肝血流量，可使利多卡因Ⅱ总清除率下降；(5)与下列药品有配伍禁忌：苯巴比妥，硫喷妥钠，硝普钠，甘露醇，两性霉素B，氨苄西林，磺胺嘧啶
西索米星	两性霉素B	药效降低，不良反应增加	西索米星不宜与两性霉素B、头孢噻吩钠、呋喃妥因钠、磺胺嘧啶钠和四环素等(以上均为注射液)联合应用，因可发生配伍禁忌
复方氨酚愈敏	阿托品	不良反应增加	奎尼丁和复方氨酚愈敏合用，其阿托品样效应加剧
琥珀胆碱	新霉素	药效提高	与下列药物合用也须谨慎，如：吩噻嗪类、普鲁卡因胺、奎尼丁、卡那霉素、多粘菌素B、新霉素等有去极化型肌松作用，能增强琥珀胆碱作用
利多卡因	两性霉素B	药效提高，不良反应增加	与西咪替丁以及β受体阻断剂如，普萘洛尔、美托洛尔、纳多洛尔合用，利多卡因经肝脏代谢受抑制，利多卡因血浓度增加，可发生心脏和神经系统不良反应，应调整利多卡因剂量，并应心电图监护及监测利多卡因血药浓度；(2)巴比妥类药物可促进利多卡因代谢，两药合用可引起心动过缓，窦性停搏；(3)与普鲁卡因胺合用，可产生一过性谵妄及幻觉，但不影响利多卡因血药浓度；(4)异丙基肾上腺素因增加肝血流量，可使利多卡因的总清除率升高；去甲肾上腺素因减少肝血流量，可使利多卡因总清除率下降；(5)与下列药品有配伍禁忌：苯巴比妥，硫喷妥钠，硝普钠，甘露醇，两性霉素B，氨苄西林，磺胺嘧啶
注射用埃索美拉唑钠	氯米帕明	药效提高	CYP2C19是埃索美拉唑的主要代谢酶，故当注射用埃索美拉唑钠与经CYP2C19代谢的药物(如地西泮、西酞普兰、丙米嗪、氯米帕明、苯妥英等)合用时，这些药物的血浆浓度可被升高，可能需要降低剂量
右酮洛芬	丙磺舒	药效提高，不良反应增加	右酮洛芬不应与丙磺舒同用，因后者可明显降低右酮洛芬肾脏清除率(降低66%)和蛋白结合率(降低28%)，导致血药浓度增高，而有引起中毒的危险
羧苄西林	链霉素	药效降低，不良反应增加	羧苄西林与琥珀氯霉素、琥乙红霉素、盐酸土霉素、盐酸四环素、卡那霉素、链霉素、庆大霉素、妥布霉素、两性霉素B、维生素B族、维生素C、苯妥英钠、拟交感类药物、异丙嗪等有配伍禁忌
噻吗洛尔滴眼液	钙通道拮抗剂	不良反应增加	噻吗洛尔滴眼液与洋地黄类和钙通道拮抗剂合用可进一步延长房室传导时间
兰索拉唑	安定	药效提高	兰索拉唑会延迟安定（diazepam）及苯妥英钠（phenytoin）的代谢与排泄；使对乙酰氨基酚的血药浓度峰值升高，达峰时间缩短
罗格列酮	吉非贝齐	药效提高	吉非贝齐：与单独使用罗格列酮（4mg，每天一次）相比，罗格列酮（4mg，一天一次）合用CYP2C8抑制剂吉非贝齐（600mg，一天两次）7天后，可增加罗格列酮AUC127%
阿米卡星	两性霉素B	药效降低，不良反应增加	阿米卡星不宜与两性霉素B、头孢噻吩、磺胺嘧啶和四环素等注射剂联合应用，因可发生配伍禁忌
双氯非那胺	阿托品	药效提高，不良反应增加	与苯丙胺、抗M-胆碱药、尤其是和阿托品、奎尼丁联合应用时，由于形成碱性尿，双氯非那胺排泄减少，会使不良反应加重或延长
布洛芬	口服降糖药	不良反应增加	合并用药时请注意下列事项：1.口服降糖药、甲氨喋呤、苯妥英、毛地黄、锂剂及饮酒等，可降低布洛芬耐受量
氟康唑氯化钠	特非那丁	药效提高	氟康唑氯化钠每日400毫克或更高剂量与特非那丁合用时，可明显升高特非那丁的血药浓度
依诺沙星	环孢素	药效提高	环孢素与依诺沙星合用时．其血药浓度升高，必须监测环孢素血浓度，并调整剂量
水杨酸	口服降糖药	药效提高	胰岛素或口服降糖药物的降糖效果可因与水杨酸同用而加强和加速；
辛伐他汀	伊曲康唑	不良反应增加	当辛伐他汀与其它在治疗剂量下对细胞色素P4503A4有明显抑制作用的药物（如：环孢霉素、米贝地尔、伊曲康唑、酮康唑、红霉素、克拉霉素和奈法唑酮）或纤维酸类衍生物或盐酸合用时，导致横纹肌溶解的危险性增高
维生素K1	维生素B12	药效降低，不良反应增加	维生素K1与苯妥英钠混合2小时后可出现颗粒沉淀，与维生素C、维生素B12、右旋糖酐混合易出现混浊
胰岛素	水杨酸	药效提高	抗凝血药、水杨酸盐、磺胺类药及抗肿瘤药甲氨蝶呤等可与胰岛素竞争和血浆蛋白结合，从而使血液中游离胰岛素水平增高
头孢米诺	氨茶碱	药效降低，不良反应增加	本口与氨茶碱、磷酸吡哆醛配伍会降低效价或着色，故不得配伍；与呋喃硫胺、硫辛酸，氢化可的松琥珀酸钠及腺苷钴胺配伍后时间稍长会变色，故配伍后应尽快使用；与利尿剂呋(呋喃苯胺酸等)等合用有可能增加肾毒性，应谨慎使用，动物实验证实，头孢米诺影响酒精代谢，使血中乙醛浓度上升，显示双硫仑样作用，故用药期间或用药后应禁酒
水杨酸钠片	水杨酸类	不良反应增加	水杨酸钠片与其他水杨酸类药物合用时，可增强它们的毒性
左旋多巴注射液	金刚烷胺	药效提高	金刚烷胺、苯扎托品、丙环定或苯海索与左旋多巴注射液同用时，可加强左旋多巴的疗效，但有精神病史者不主张同用
普鲁卡因胺	降压药	不良反应增加	降压药合用，尤其静注普鲁卡因胺时，降压作用可增强；④与拟胆碱药合用时，普鲁卡因胺可抑制这类药对横纹肌的效应；⑤与神经肌肉阻滞剂（包括去极化型和非去极化型阻滞剂）合用时，神经肌肉接头的阻滞作用增强，时效延长；⑥酒精可以增加该药的清除率，缩短其半衰期；⑦抗酸药物可以降低其生物利用度，因此不建议两者合用；⑧西咪替丁可以降低普鲁卡因胺和N-乙酰普鲁卡因胺的肾清除率，因此两药合用时需减低普鲁卡因胺的用量；⑨雷尼替丁可影响该药在肾脏的代谢，合用时注意调整用量；⑩甲氧苄啶可以降低普鲁卡因胺和N-乙酰普鲁卡因胺的肾清除率，合用时需减低普鲁卡因胺的用量
普萘洛尔	哌唑嗪	药效提高	口服避孕药、环丙沙星、舍曲林、氟西汀、哌唑嗪、胰岛素等药可增强普萘洛尔作用
罗格列酮	万古霉素	药效提高	虽然这种与阳离子药物（如，阿米洛利、地高辛、吗啡、普鲁卡因酰胺、奎尼丁、奎宁、雷尼替丁、氨苯喋啶、甲氧苄啶和万古霉素）的相互作用仍然是理论上的（西咪替丁除外），但使用经近端肾小管分泌系统排泄的阳离子药物的患者，用罗格列酮治疗时应当密切观察病情，调整罗格列酮和/或干扰药物的剂量
盐酸氨溴索口服溶液	抗生素	药效提高	盐酸氨溴索口服溶液与抗生素（阿莫西林、头孢呋辛、红霉素、强力霉素）同时服用，可导致抗生素在肺组织浓度升高
普鲁卡因	甲氧苄啶	药效提高	降压药合用，尤其静注普鲁卡因时，降压作用可增强；④与拟胆碱药合用时，普鲁卡因可抑制这类药对横纹肌的效应；⑤与神经肌肉阻滞剂（包括去极化型和非去极化型阻滞剂）合用时，神经肌肉接头的阻滞作用增强，时效延长；⑥酒精可以增加该药的清除率，缩短其半衰期；⑦抗酸药物可以降低其生物利用度，因此不建议两者合用；⑧西咪替丁可以降低普鲁卡因胺和N-乙酰普鲁卡因胺的肾清除率，因此两药合用时需减低普鲁卡因胺的用量；⑨雷尼替丁可影响该药在肾脏的代谢，合用时注意调整用量；⑩甲氧苄啶可以降低普鲁卡因胺和N-乙酰普鲁卡因胺的肾清除率，合用时需减低普鲁卡因胺的用量
文拉法辛	色氨酸	不良反应增加	类似其它5-羟色胺能药物，使用文拉法辛治疗时，可能发生5-羟色胺综合征(一种有潜在生命威胁的情况)，尤其是在与以下药物合并使用时：其它作用于5-羟色胺递质系统的药物(包括曲坦、SSRIs、其它SNRIs、锂盐、西布曲明、曲马多或圣约翰草[金丝桃属植物提取物])，损害5-羟色胺代谢的药物如MAOIs，包括利奈唑胺[一种抗生素，是可逆性、非选择性的MAOI见[禁忌])，或5-羟色胺前体(如：色氨酸补充剂)
头孢哌酮	抑肽酶	药效降低，不良反应增加	头孢哌酮与安太乐、普鲁卡因胺、氨茶碱、丙氯拉嗪、细胞色素C、镇痛新、抑肽酶混合后1/2小时发生外观变化
加兰他敏	酮康唑	药效提高	多剂量给药药代动力学研究证明，加兰他敏在与酮康唑及帕罗西汀同服时AUC分别增加了30%和40%
氨丁三醇	丙磺舒	药效提高，不良反应增加	氨丁三醇不应与丙磺舒同用，因后者可明显降低氨丁三醇肾脏清除率(降低66%)和蛋白结合率(降低28%)，导致血药浓度增高，而有引起中毒的危险
氯氮卓	抗真菌药	药效提高，不良反应增加	氯氮卓与抗真菌药酮康唑、伊曲康唑合用，可提高氯氮卓疗效并增加其毒性
塞瑞替尼胶囊	伏立康唑	药效提高	如果同时使用强效CYP3A抑制剂（包括但不限于利托那韦、沙奎那韦、泰利霉素、酮康唑、伊曲康唑、伏立康唑、泊沙康唑、奈法唑酮）无法避免，则应将塞瑞替尼胶囊的剂量减少约三分之一，并近似为150mg剂量规格的倍数
托特罗定	克拉霉素	药效提高，不良反应增加	不建议与强CYP3A4抑制剂，如大环内酯抗生素（如，红霉素和克拉霉素），抗真菌药（如，酮康唑，咪康唑和伊曲康唑）和抗蛋白酶合并全身给药，因为托特罗定在CYP2D6弱代谢者中的血清浓度会升高，（之后）出现过量的风险（见药物过量）
瑞舒伐他汀	抗凝剂	不良反应增加	维生素K拮抗剂：同其它HMG－CoA还原酶抑制剂一样，对同时使用维生素K拮抗剂(如：华法林或其他香豆素类抗凝剂)的患者，开始使用瑞舒伐他汀或逐渐增加瑞舒伐他汀剂量可能导致国际标准化比率(INR)升高
氨苄西林	苯巴比妥	药效降低，不良反应增加	氨苄西林与氨基糖苷类、去甲肾上腺素、间羟胺、苯巴比妥、维生素B族、维生素C等药物存在配伍禁忌，不宜同瓶滴注
环孢素软胶囊	达那唑	药效提高	提高环孢素软胶囊血浆或全血浓度的药品有：酮康唑、氟康唑、伊曲康唑、红霉素、交沙霉素、克拉霉素等大环内酯类抗生素，强力霉素、口服避孕药、普罗帕酮以及地尔硫卓、尼卡地平、维拉帕米等钙拮抗剂，氟伏沙明、乙酰唑胺、甲氧氯普胺、达那唑、甲泼尼龙（高剂量）、别嘌醇、胺碘酮、胆酸及其衍生物、蛋白酶抑制剂
阿莫西林	醋硝香豆素	药效提高	然而，根据文献，使用醋硝香豆素或华法林的患者合并使用一个疗程的阿莫西林，有国际标准化比值增加的情况
复方愈创木酚磺酸钾口服溶液	乙醇	不良反应增加	与乙醇、镇静、催眠药、抗过敏药并用可增加复方愈创木酚磺酸钾口服溶液对中枢的抑制作用
阿昔洛韦	丙磺舒	药效提高	与丙磺舒竞争性抑制有机酸分泌,合并用丙磺舒可使阿昔洛韦的排泄减慢,半衰期延长,体内药物量蓄积
头孢克洛	抗凝血	药效提高	在个别情况下，当患者服用头孢克洛的同时，服用香豆素类的抗凝血药，可能会出现凝血时间延长
单硝酸异山梨酯	双氢麦角胺	药效提高	单硝酸异山梨酯可增强双氢麦角胺的升血压效应
氢氯噻嗪	伊曲康唑	药效提高，不良反应增加	氢氯噻嗪与抗真菌药酮康唑、伊曲康唑合用，可提高氢氯噻嗪疗效并增加其毒性
奈福泮	喷他佐辛	不良反应增加	奈福泮与可待因、喷他佐辛、右丙氧酚合用时，后者的副作用和成瘾性增强
肝素	万古霉素	药效降低，不良反应增加	下列药物与肝素有配伍禁忌：卡那霉素、阿米卡星、柔红霉素、乳糖酸红霉素、硫酸庆大霉素、氢化考的松琥珀酸钠、多粘菌素B、阿霉素、妥布霉素、万古霉素、头孢孟多、头孢氧哌唑、头孢噻吩钠、氯喹丙嗪、异丙嗪、麻醉性镇痛药
环磷酰胺	双氢克尿噻	不良反应增加	如果环磷酰胺与别嘌呤醇或双氢克尿噻同时给药则可能加重骨髓抑制
辛伐他汀片	吉非贝齐	不良反应增加	辛伐他汀片与甲基羟戊二酰辅酶A(HMG-COA)还原酶抑制剂合并用药会增加肌病的发生率和严重程度，这些药物包括吉非贝齐和其他贝特类，以及降脂剂量的烟酸(大于等于1g/d)
普鲁卡因	降压药	药效提高	降压药合用，尤其静注普鲁卡因时，降压作用可增强；④与拟胆碱药合用时，普鲁卡因可抑制这类药对横纹肌的效应；⑤与神经肌肉阻滞剂（包括去极化型和非去极化型阻滞剂）合用时，神经肌肉接头的阻滞作用增强，时效延长；⑥酒精可以增加该药的清除率，缩短其半衰期；⑦抗酸药物可以降低其生物利用度，因此不建议两者合用；⑧西咪替丁可以降低普鲁卡因胺和N-乙酰普鲁卡因胺的肾清除率，因此两药合用时需减低普鲁卡因胺的用量；⑨雷尼替丁可影响该药在肾脏的代谢，合用时注意调整用量；⑩甲氧苄啶可以降低普鲁卡因胺和N-乙酰普鲁卡因胺的肾清除率，合用时需减低普鲁卡因胺的用量
利多卡因Ⅱ	去甲肾上腺素	药效提高，不良反应增加	与西咪替丁以及β受体阻断剂如，普萘洛尔、美托洛尔、纳多洛尔合用，利多卡因经肝脏代谢受抑制，利多卡因血浓度增加，可发生心脏和神经系统不良反应，应调整利多卡因剂量，并应心电图监护及监测利多卡因血药浓度；(2)巴比妥类药物可促进利多卡因代谢，两药合用可引起心动过缓，窦性停搏；(3)与普鲁卡因胺合用，可产生一过性谵妄及幻觉，但不影响利多卡因Ⅱ血药浓度；(4)异丙基肾上腺素因增加肝血流量，可使利多卡因Ⅱ的总清除率升高；去甲肾上腺素因减少肝血流量，可使利多卡因Ⅱ总清除率下降；(5)与下列药品有配伍禁忌：苯巴比妥，硫喷妥钠，硝普钠，甘露醇，两性霉素B，氨苄西林，磺胺嘧啶
茶碱Ⅱ	罗红霉素	药效提高，不良反应增加	克林霉素、林可霉素及某些大环内酯类（红霉素、罗红霉素、克拉霉素）、喹诺酮类抗菌药（伊诺沙星、环丙沙星）合用时，可降低茶碱Ⅱ在肝脏的代谢，血药浓度升高，甚至出现毒性，应在给药前后调整茶碱Ⅱ的用量
舒巴坦	阿莫西林	药效提高	丙磺舒竞争性减少舒巴坦的肾小管分泌，两者同时应用可引起阿莫西林血药浓度升高、半衰期延长；
加兰他敏	氟伏沙明	药效提高	阿尔茨海默病患者人群药代动力学分析显示，与CYP2D6酶抑制剂(阿米替林、氟西汀、氟伏沙明、帕罗西汀及奎尼丁)同服，加兰他敏的清除率减少了约25%－33%
佐米曲普坦片	西咪替丁	药效提高	与西咪替丁、口服避孕药合用时,也可使佐米曲普坦片的血药浓度增加
脂肪乳注射液	琥珀胆碱	不良反应增加	脂肪乳注射液和琥珀胆碱或新斯的明合用后，可能出现心动过缓或心跳骤停
硝西泮	抗真菌药	药效提高，不良反应增加	硝西泮与抗真菌药酮康唑、伊曲康唑合用，可提高硝西泮疗效并增加其毒性
罗格列酮	吉非贝齐	药效提高	罗格列酮与CYP2C8抑制剂（如吉非贝齐）联合用药，可能升高罗格列酮血浆浓度（参加药代动力学）
拉呋替丁颗粒	苯妥英钠	药效提高，不良反应增加	其它H2受体阻滞药能与细胞色素P450结合，从而降低肝微粒体药物代谢酶的活性，因此拉呋替丁颗粒与华法林、苯妥英钠、茶碱、苯巴比妥、安定或普奈洛尔和西米替丁合用时应注意
地奈德	环孢素	药效提高，不良反应增加	布地奈德的代谢转化可被由CYP3A4代谢的物质（例如伊曲康唑、酮康唑、利托那韦、奈非那韦、环孢素、炔雌醇和醋竹桃霉素）所抑制
瑞舒伐他汀	维生素K拮抗剂	不良反应增加	维生素K拮抗剂：同其它HMG－CoA还原酶抑制剂一样，对同时使用维生素K拮抗剂(如：华法林或其他香豆素类抗凝剂)的患者，开始使用瑞舒伐他汀或逐渐增加瑞舒伐他汀剂量可能导致国际标准化比率(INR)升高
肝素	氯喹	药效降低，不良反应增加	下列药物与肝素有配伍禁忌：卡那霉素、阿米卡星、柔红霉素、乳糖酸红霉素、硫酸庆大霉素、氢化考的松琥珀酸钠、多粘菌素B、阿霉素、妥布霉素、万古霉素、头孢孟多、头孢氧哌唑、头孢噻吩钠、氯喹丙嗪、异丙嗪、麻醉性镇痛药
雷贝拉唑	酮康唑	药效提高	例如，正常受试者如果每天同时服用酮康唑与20mg雷贝拉唑钠，会使酮康唑的生物利用度减少大约30％；同时服用地高辛，会使地高辛的AUC和Cmax值分别增加19％和29％
肌苷氯化钠注射液	二盐酸奎宁	药效降低，不良反应增加	肌苷氯化钠注射液禁与下列注射液配伍：乳清酸、氯霉素、双嘧达莫、盐酸山梗菜碱、硫酸阿托品、氢溴酸东莨菪碱、盐酸氯丙嗪、盐酸异丙嗪、马来酸麦角新碱、盐酸普鲁卡因、硫喷妥钠、苯妥英钠、氯氮卓、盐酸去甲肾上腺素、盐酸丁卡因、利血平、硝普钠、降压嗪、呋噻米、利尿酸钠、促皮质素、维生素B12、盐酸苯海拉明、马来酸氯苯那敏、细胞色素C、盐酸万古霉素、盐酸四环素、二盐酸奎宁、盐酸阿糖胞苷、硫酸长春新碱以及所有菌苗和疫苗
地高辛	奎尼丁	药效提高，不良反应增加	与奎尼丁合用，可使地高辛血药浓度提高约一倍，提高程度与奎尼丁用量相关，甚至可达到中毒浓度，即使停用地高辛，其血药浓度仍继续上升，这是奎尼丁从组织结合处置换出地高辛，减少其分布容积之故
氨氯地平	硝酸酯	药效提高	舌下硝酸甘油和长效硝酸酯制剂：与氨氯地平合用可加强抗心绞痛效应
噻吗洛尔	帕罗西汀	药效提高，不良反应增加	·已有报道噻吗洛尔与CYP2D6抑制剂（如奎尼丁、氟西汀、帕罗西汀）联合治疗时，有潜在的全身β-受体阻滞作用（如心率降低，抑郁）
二氟尼柳片	萘普生	药效提高	二氟尼柳片与萘普生同用时，可显著降低萘普生及代谢产物自尿中的排泄
右旋布洛芬	甲氨蝶呤	药效提高，不良反应增加	右旋布洛芬可降低甲氨蝶呤的排泄，增高其血浓度，甚至可达中毒水平，故右旋布洛芬不应与中或大剂量甲氨蝶呤同用
头孢他啶	卡那霉素	药效降低，不良反应增加	头孢他啶与下列药物有配伍禁忌：硫酸阿米卡星、庆大霉素、卡那霉素
佐匹克隆	酮康唑	药效提高	与400mg酮康唑(一种CYP3A4的强抑制剂)合用5天可使右佐匹克隆AUC增加2.2倍
头孢米诺	呋喃苯胺酸	药效降低，不良反应增加	本口与氨茶碱、磷酸吡哆醛配伍会降低效价或着色，故不得配伍；与呋喃硫胺、硫辛酸，氢化可的松琥珀酸钠及腺苷钴胺配伍后时间稍长会变色，故配伍后应尽快使用；与利尿剂呋(呋喃苯胺酸等)等合用有可能增加肾毒性，应谨慎使用，动物实验证实，头孢米诺影响酒精代谢，使血中乙醛浓度上升，显示双硫仑样作用，故用药期间或用药后应禁酒
布洛伪麻软胶囊	口服降糖药	药效提高，不良反应增加	布洛伪麻软胶囊与地高辛、甲氨蝶呤、口服降糖药同时服用，能使这些药物的血药浓度增高，不良反应增加
丙胺太林	红霉素	药效提高	如红霉素可因在胃内停留过长而受到胃酸分解，降低疗效，对乙酰氨基酚的吸收可被延迟，血浆峰浓度降低；地高辛的血浆浓度可因同用丙胺太林而提高
地巴唑	伊曲康唑	药效提高，不良反应增加	地巴唑与抗真菌药酮康唑、伊曲康唑合用，可提高地巴唑疗效并增加其毒性
非索非那定	酮康唑	药效提高	在体内动物研究中也表明除增加吸收之外，酮康唑降低了盐酸非索非那定的胃肠分泌，而红霉素也可能降低胆汁排泄
比索洛尔	抗心律失常药物	药效提高	Ⅰ类抗心律失常药物（如丙吡胺、奎尼丁），可能增加比索洛尔对房室传导和心脏收缩力的抑制作用
异丙嗪胆汁片	三环类抗抑郁药	药效提高	醇或其他中枢神经抑制剂，特别是麻醉药、巴比妥类、单胺氧化酶抑制剂或三环类抗抑郁药与异丙嗪胆汁片同服时，可增强盐酸异丙嗪或(和)这些药物的效应
青霉素	丙磺舒	药效提高	丙磺舒可减少苯唑西林的肾小管分泌，延长青霉素的血清半衰期
阿立哌唑	奎尼丁	药效提高	CYP3A4抑制剂（如酮康唑）或CYP2D6抑制剂（如奎尼丁、氟西汀、帕罗西汀）可以抑制阿立哌唑消除，使血药浓度升高
替诺福韦	阿扎那韦	药效提高	c.在HIV感染受试者中，将富马酸替诺福韦二吡呋酯加入阿扎那韦300mg+利托那韦100mg，结果显示阿扎那韦的AUC和Cmin值分别比阿扎那韦400mg单用时所观测值高2.3倍和4倍
伪麻那敏	肝素	药效提高，不良反应增加	伪麻那敏与肝素、双香豆素等抗凝血药合用时，可导致凝血酶原时间延长，增加出血倾向
复方蒿甲醚	奎宁	不良反应增加	因此，复方蒿甲醚预先给药似乎增强了与静脉注射奎宁相关的QTc-延长的内在性风险，因为本芴醇的清除半衰期较长以及潜在的QT间期叠加效应
单硝酸异山梨酯Ⅳ	双氢麦角胺	药效提高	单硝酸异山梨酯Ⅳ可增强双氢麦角胺的升血压效应
地尔硫卓Ⅱ	卡马西平	药效提高，不良反应增加	卡马西平：地尔硫卓Ⅱ与卡马西平合用后，一些病例中可使卡马西平的血药浓度增高40%-72%而导致毒性
肌苷氯化钠注射液	硫酸长春新碱	药效降低，不良反应增加	肌苷氯化钠注射液禁与下列注射液配伍：乳清酸、氯霉素、双嘧达莫、盐酸山梗菜碱、硫酸阿托品、氢溴酸东莨菪碱、盐酸氯丙嗪、盐酸异丙嗪、马来酸麦角新碱、盐酸普鲁卡因、硫喷妥钠、苯妥英钠、氯氮卓、盐酸去甲肾上腺素、盐酸丁卡因、利血平、硝普钠、降压嗪、呋噻米、利尿酸钠、促皮质素、维生素B12、盐酸苯海拉明、马来酸氯苯那敏、细胞色素C、盐酸万古霉素、盐酸四环素、二盐酸奎宁、盐酸阿糖胞苷、硫酸长春新碱以及所有菌苗和疫苗
阿莫西林克拉维酸钾	保泰松	药效提高，不良反应增加	阿司匹林、吲哚美辛、保泰松、磺胺药、丙磺舒可减少阿莫西林克拉维酸钾在肾小管的排泄，因而可使阿莫西林克拉维酸钾的血药浓度升高，而且维持较久，血消半衰期延长，毒性也可能增加
头孢哌酮	甲氯芬酯	药效降低，不良反应增加	头孢哌酮与下列药物注射剂有配伍禁忌：阿米卡星、庆大霉素、卡那霉素B、多西环素、甲氯芬酯、阿马林(缓脉灵)、苯海拉明、门冬酸钾镁、盐酸羟嗪(安太乐)、普鲁卡因胺、氨茶碱、丙氯拉嗪、细胞色素C、喷他佐辛(镇痛新)、抑肽酶等
对乙酰氨基酚口腔崩解片	抗病毒药	不良反应增加	对乙酰氨基酚口腔崩解片与抗病毒药齐多夫定(Zidovudine)合用时，由于两药可相互降低与葡糖醛酸的结合作用而降低清除率，从而增加毒性，应避免同时应用
甲苯磺酸索拉非尼片	紫杉醇	药效提高	紫杉醇（225mg/m2，每3周1次）及卡铂（AUC=6）联合甲苯磺酸索拉非尼片（0.4g，每日两次，不间断甲苯磺酸索拉非尼片给药）使用时，致使索拉非尼体内暴露量增加47%，紫杉醇体内暴露量增加29%，6－羟基紫杉醇体内暴露量增加50%
阿立哌唑	奎尼丁	药效提高	当同时服用奎尼丁和阿立哌唑时，应将阿立哌唑的常用剂量降低一半
头孢呋辛	抗生素	不良反应增加	对于正接受强效利尿剂如速尿并行治疗的患者，给予大剂量的头孢菌素类抗生素时应特别注意，因为如此合并使用，有对肾功能产生不良反应之虞，头孢呋辛临床使用经验证明，推荐剂量下使用，不致发生影响
醋硝香豆素片	苯乙双胍	药效提高	能促进使醋硝香豆素片与受体结合的药物，奎尼丁、甲状腺素、同化激素、苯乙双胍
甘露醇	华法林	药效提高	甘露醇与抗凝药华法林合用时虽对后者的抗凝作用增强较小，但合用时也应严密监测患者的凝血酶原时间
米非司酮	伊曲康唑	药效提高	米非司酮在体内主要由肝脏的CYP3A4酶代谢，与酮康唑、伊曲康唑、红霉素等药物合用可能增加血清米非司酮水平
西米替丁	四环素	药效提高	由于西米替丁使胃液pH值升高，与四环素合用时，可致四环素的溶解速率下降、吸收减少、作用减弱（但西米替丁的肝药酶抑制作用却可能增加四环素的血药浓度）；若与阿司匹林合用，则出现相反的结果，可使阿司匹林的作用增强
利多卡因Ⅰ	普鲁卡因胺	药效提高，不良反应增加	与西咪替丁以及b受体阻断剂如，普萘洛尔、美托洛尔、纳多洛尔合用，利多卡因经肝脏代谢受抑制，利多卡因血浓度增加，可发生心脏和神经系统不良反应，应调整利多卡因剂量，并应心电图监护及监测利多卡因血药浓度；（2）巴比妥类药物可促进利多卡因代谢，两药合用可引起心动过缓，窦性停搏；（3）与普鲁卡因胺合用，可产生一过性谵妄及幻觉，但不影响利多卡因Ⅰ血药浓度；（4）异丙基肾上腺素因增加肝血流量，可使利多卡因Ⅰ的总清除率升高；去甲肾上腺素因减少肝血流量，可使利多卡因Ⅰ总清除率下降；（5）与下列药品有配伍禁忌：苯巴比妥，硫喷妥钠，硝普钠，甘露醇，两性霉素B，氨苄西林，磺胺嘧啶
利多卡因Ⅱ	苯巴比妥	药效提高，不良反应增加	与西咪替丁以及β受体阻断剂如，普萘洛尔、美托洛尔、纳多洛尔合用，利多卡因经肝脏代谢受抑制，利多卡因血浓度增加，可发生心脏和神经系统不良反应，应调整利多卡因剂量，并应心电图监护及监测利多卡因血药浓度；(2)巴比妥类药物可促进利多卡因代谢，两药合用可引起心动过缓，窦性停搏；(3)与普鲁卡因胺合用，可产生一过性谵妄及幻觉，但不影响利多卡因Ⅱ血药浓度；(4)异丙基肾上腺素因增加肝血流量，可使利多卡因Ⅱ的总清除率升高；去甲肾上腺素因减少肝血流量，可使利多卡因Ⅱ总清除率下降；(5)与下列药品有配伍禁忌：苯巴比妥，硫喷妥钠，硝普钠，甘露醇，两性霉素B，氨苄西林，磺胺嘧啶
沙丁胺醇	茶碱类	药效提高，不良反应增加	沙丁胺醇与茶碱类药品并用时，可增加松弛支气管平滑肌的作用，但也可能增加不良反应
盐酸氟西汀肠溶片	曲马多	不良反应增加	羟色胺激动剂：盐酸氟西汀肠溶片与5-羟色胺激动剂（如曲马多、曲坦类）合用，可能增加5-羟色胺综合征的风险
利多卡因Ⅰ	苯巴比妥	药效降低，不良反应增加	与西咪替丁以及β受体阻断剂如，普萘洛尔、美托洛尔、纳多洛尔合用，利多卡因经肝脏代谢受抑制，利多卡因血浓度增加，可发生心脏和神经系统不良反应，应调整利多卡因剂量，并应心电图监护及监测利多卡因血药浓度；(2)巴比妥类药物可促进利多卡因代谢，两药合用可引起心动过缓，窦性停搏；(3)与普鲁卡因胺合用，可产生一过性谵妄及幻觉，但不影响利多卡因Ⅰ血药浓度；(4)异丙基肾上腺素因增加肝血流量，可使利多卡因Ⅰ的总清除率升高；去甲肾上腺素因减少肝血流量，可使利多卡因Ⅰ总清除率下降；(5)与下列药品有配伍禁忌：苯巴比妥，硫喷妥钠，硝普钠，甘露醇，两性霉素B，氨苄西林，磺胺嘧啶
苯妥英钠	利多卡因	不良反应增加	苯妥英钠与利多卡因或心得安合用时可能加强心脏的抑制作用
注射用头孢地嗪钠	顺铂	不良反应增加	注射用头孢地嗪钠可加强具有潜在肾毒性药物的毒性作用，如与氨基糖甙类、两性霉素B、环孢素、顺铂、万古霉素、多粘菌素B或粘菌素同时或先后使用时应密切监测肾功能
他克莫司	奎尼丁	药效提高，不良反应增加	已知会抑制细胞色素P4503A4酶系统的药物：根据体外试验，下列药物可以视为他克莫司代谢的潜在性抑制剂：溴麦亭、可的松、氨苯砜、麦角胺、乙炔雌二醇、甲地孕酮、依他康唑、交沙霉素、利多卡因、甲妥因、咪康唑、尼卡地平、尼鲁地平、尼伐地平、炔诺酮、奎尼丁、他莫昔芬、三醋酸竹桃霉素、维拉帕米
胰岛素	酮康唑	药效提高，不良反应增加	血管紧张素酶抑制剂、溴隐亭、氯贝特、酮康唑、锂、甲苯咪唑、吡多辛、茶碱等可通过不同方式直接或间接致血糖降低，胰岛素与上述药物合用时应适当减量
普鲁卡因	新斯的明	不良反应增加	新斯的明等抗胆碱脂酶药物可干扰普鲁卡因中普鲁卡因代谢，使普鲁卡因毒性增强，忌联合应用
利托那韦口服溶液	匹莫齐特	不良反应增加	阿普唑仑、安非他酮、胺碘酮、阿咪唑、苄替地尔、西沙必利、氯拉折帕、氯氮平、右丙氧芬、地西泮、二氢麦角胺、恩卡肢、舒乐安定、麦角胺、氟卡胺、氟西泮、咪达唑仑、哌替啶、匹莫齐特、吡罗昔康、普罗帕酮、奎尼丁、利福布丁、特非那定、三唑仑和左吡登禁止用于利托那韦口服溶液治疗的病人，因为它们可能与利托那韦口服溶液发生相互作用，产生严重并发症的危险
纳洛酮	丁丙诺啡	不良反应增加	监测接受肌肉松弛剂和丁丙诺啡治疗患者的呼吸抑制体征（可能比非联合用药时的预期要严重），必要时减少丁丙诺啡/纳洛酮舌下片和/或肌肉松弛剂的用药剂量
氯霉素	雌激素	药效降低，不良反应增加	长期口服含雌激素的避孕药者合用氯霉素时，可使避孕的可靠性降低，以及经期外出血增加
利托那韦口服溶液	奎尼丁	不良反应增加	阿普唑仑、安非他酮、胺碘酮、阿咪唑、苄替地尔、西沙必利、氯拉折帕、氯氮平、右丙氧芬、地西泮、二氢麦角胺、恩卡肢、舒乐安定、麦角胺、氟卡胺、氟西泮、咪达唑仑、哌替啶、匹莫齐特、吡罗昔康、普罗帕酮、奎尼丁、利福布丁、特非那定、三唑仑和左吡登禁止用于利托那韦口服溶液治疗的病人，因为它们可能与利托那韦口服溶液发生相互作用，产生严重并发症的危险
美洛西林	保泰松	药效提高，不良反应增加	丙磺舒、阿司匹林、吲哚美辛、保泰松、磺胺药可减少美洛西林自肾脏排泄，因此与美洛西林合用时使其血药浓度增高，排泄时间延长，毒性也可能增加
丙帕他莫	巴比妥类	不良反应增加	在长期饮酒或应用其他肝酶诱导剂，尤其是应用巴比妥类或其他抗惊厥药的患者，长期或大量服用丙帕他莫时，更有发生肝脏毒性的危险
阿利吉仑	ARB	不良反应增加	阿利吉仑与其他作用于RAAS系统的药物，如ACEI或ARB类联合使用时，与单药治疗相比，可导致低血压、高钾血症的风险增加和肾功能（包括急性肾衰竭）的改变
异卡波肼	左旋多巴	不良反应增加	异卡波肼与左旋多巴合用，可发生急性肾上腺危象
注射用头孢地嗪钠	万古霉素	不良反应增加	注射用头孢地嗪钠可加强具有潜在肾毒性药物的毒性作用，如与氨基糖苷类、两性霉素B、环孢素、顺铂、万古霉素、多粘菌素B或粘菌素同时或先后使用时，应密切监测肾功能
洛伐他汀	伊曲康唑	不良反应增加	洛伐他汀与免疫抑制剂如环孢素、阿奇霉素、克拉霉素、红霉素、达那唑、伊曲康唑、吉非罗齐、烟酸等合用可增加肌溶解和急性肾功能衰竭发生的危险
依诺沙星	茶碱类	药效提高，不良反应增加	依诺沙星与茶碱类合用时可能由于与细胞色素P450结合部位的竞争性抑制，导致茶碱类的肝消除明显减少，血消除半衰期(t1/2β)延长，血药浓度升高，出现茶碱中毒症状，如恶心、呕吐、震颤、不安、激动、抽搐、心悸等，应避免合用，不能避免时应测定茶碱类血药浓度并调整剂量
甘草酸二铵注射液	利尿剂	药效提高，不良反应增加	与利尿酸、速尿、乙噻嗪、三氯甲噻嗪等利尿剂合用时，其利尿作用可增强甘草酸二铵注射液所含甘草酸二铵的排钾作用，宜导致血清钾值的下降，应特别注意观察血清钾值的测定
双氯芬酸	甲氨喋呤	药效提高，不良反应增加	双氯芬酸可降低甲氨喋呤的排泄，增高其血浓度，甚至可达中毒水平，故双氯芬酸不应与中或大剂量甲氨喋呤同用
利多卡因	硝普钠	药效提高，不良反应增加	与西咪替丁以及b受体阻断剂如，普萘洛尔、美托洛尔、纳多洛尔合用，利多卡因经肝脏代谢受抑制，利多卡因血浓度增加，可发生心脏和神经系统不良反应，应调整利多卡因剂量，并应心电图监护及监测利多卡因血药浓度；（2）巴比妥类药物可促进利多卡因代谢，两药合用可引起心动过缓，窦性停搏；（3）与普鲁卡因胺合用，可产生一过性谵妄及幻觉，但不影响利多卡因血药浓度；（4）异丙基肾上腺素因增加肝血流量，可使利多卡因的总清除率升高；去甲肾上腺素因减少肝血流量，可使利多卡因总清除率下降；（5）与下列药品有配伍禁忌：苯巴比妥，硫喷妥钠，硝普钠，甘露醇，两性霉素B，氨苄西林，磺胺嘧啶
亚叶酸钙	氟尿嘧啶	不良反应增加	亚叶酸钙可能会加强氟嘧啶（如氟尿嘧啶）的毒性
头孢哌酮	氨基糖苷类抗生素	药效降低，不良反应增加	但头孢哌酮与氨基糖苷类抗生素之间存在物理性配伍禁忌，因此两种药液不能直接混合
瑞舒伐他汀	HMG－CoA还原酶抑制剂	不良反应增加	维生素K拮抗剂：同其它HMG－CoA还原酶抑制剂一样，对同时使用维生素K拮抗剂(如：华法林或其他香豆素类抗凝剂)的患者，开始使用瑞舒伐他汀或逐渐增加瑞舒伐他汀剂量可能导致国际标准化比率(INR)升高
他克莫司	细胞色素P4503A4	药效提高，不良反应增加	已知会抑制细胞色素P4503A4酶系统的药物：根据体外试验，下列药物可以视为他克莫司代谢的潜在性抑制剂：溴麦亭、可的松、氨苯砜、麦角胺、乙炔雌二醇、甲地孕酮、依他康唑、交沙霉素、利多卡因、甲妥因、咪康唑、尼卡地平、尼鲁地平、尼伐地平、炔诺酮、奎尼丁、他莫昔芬、三醋酸竹桃霉素、维拉帕米
普鲁卡因胺	甲氧苄啶	不良反应增加	降压药合用，尤其静注普鲁卡因胺时，降压作用可增强；④与拟胆碱药合用时，普鲁卡因胺可抑制这类药对横纹肌的效应；⑤与神经肌肉阻滞剂（包括去极化型和非去极化型阻滞剂）合用时，神经肌肉接头的阻滞作用增强，时效延长；⑥酒精可以增加该药的清除率，缩短其半衰期；⑦抗酸药物可以降低其生物利用度，因此不建议两者合用；⑧西咪替丁可以降低普鲁卡因胺和N-乙酰普鲁卡因胺的肾清除率，因此两药合用时需减低普鲁卡因胺的用量；⑨雷尼替丁可影响该药在肾脏的代谢，合用时注意调整用量；⑩甲氧苄啶可以降低普鲁卡因胺和N-乙酰普鲁卡因胺的肾清除率，合用时需减低普鲁卡因胺的用量
小诺霉素	两性霉素B	药效降低，不良反应增加	诺霉素不宜与两性霉素B、头孢噻吩钠、呋喃妥因钠、磺胺嘧啶钠和盐酸四环素等（以上均为注射液）联合应用，因可发生配伍禁忌
利福平	安定	不良反应增加	利福平与地西泮(安定)合用可使肝毒性反应增加
文拉法辛	SSRIs	不良反应增加	类似其它5-羟色胺能药物，使用文拉法辛治疗时，可能发生5-羟色胺综合征(一种有潜在生命威胁的情况)，尤其是在与以下药物合并使用时：其它作用于5-羟色胺递质系统的药物(包括曲坦、SSRIs、其它SNRIs、锂盐、西布曲明、曲马多或圣约翰草[金丝桃属植物提取物])，损害5-羟色胺代谢的药物如MAOIs，包括利奈唑胺[一种抗生素，是可逆性、非选择性的MAOI见[禁忌])，或5-羟色胺前体(如：色氨酸补充剂)
肝素	氯喹	药效降低，不良反应增加	下列药物与肝素有配伍禁忌：卡那霉素、阿米卡星、柔红霉素、乳糖酸红霉素、硫酸庆大霉素、氢化考的松琥珀酸钠、多粘菌素B、阿霉素、妥布霉素、万古霉素、头孢孟多、头孢氧哌唑、头孢噻吩钠、氯喹、氯丙嗪、异丙嗪、麻醉性镇痛药
酮康唑	奎尼丁	不良反应增加	-由于酮康唑与CYP3A4底物合用会增加这些药物的血浆浓度，而可能导致QT间期延长和个别出现尖端扭转型室速，因此酮康唑禁止与下列药物合用：特非那丁、苄普地尔、阿司咪唑、卤泛群、左醋美沙朵(左美沙酮)、咪唑斯汀、西沙必利、多非利特、奎尼丁、匹莫齐特、苯丙胺、舍吲哚；
氨酚氯雷伪麻缓释片	单胺氧化酶抑制剂	不良反应增加	正在接受单胺氧化酶抑制剂治疗的患者同时服用氨酚氯雷伪麻缓释片，可能发生高血压反应，包括高血压危象
复方对乙酰氨基酚Ⅱ	口服降糖药	药效提高，不良反应增加	复方对乙酰氨基酚Ⅱ可加强口服降糖药及甲氨蝶呤的作用，不应同用
舒巴坦	氨基糖甙类	药效降低，不良反应增加	舒巴坦与氨基糖甙类抗生素有协同作用，但二者有配伍禁忌，如需并用，应分别溶解稀释后输注
叶酸	氟尿嘧啶	不良反应增加	亚叶酸钠可能增加5-氟尿嘧啶的毒性
依巴斯汀	酮康唑	药效提高，不良反应增加	研究表明当依巴斯汀与酮康唑或红霉素（已知这两种药物均可延长QT间期）联合应用时，有药物代谢动力学及药效动力学方面的相互作用，使依巴斯汀的血药浓度增高——尽管较以上两种药物单独使用仅使QT间期延长10ms，因而依巴斯汀应慎用于同时服用酮康唑或红霉素的患者
小儿复方磺胺嘧啶	磺吡酮	药效提高，不良反应增加	磺吡酮（sulfinpyrazone）与小儿复方磺胺嘧啶同用时可减少后者自肾小管的分泌，其血药浓度升高而持久或产生毒性，因此在应用磺吡酮期间或在应用其治疗后可能需要调整小儿复方磺胺嘧啶的剂量
雷米普利	磺脲类	药效提高，不良反应增加	－口服抗糖药（如磺脲类、双胍类）、胰岛素：由于潜在地降低胰岛素抵抗，雷米普利可增强降糖药效果，具产生低血糖的风险（尤其在治疗初期，应仔细监测血糖水平）
利多卡因	硫喷妥钠	药效提高，不良反应增加	与西咪替丁以及β受体阻断剂如，普萘洛尔、美托洛尔、纳多洛尔合用，利多卡因经肝脏代谢受抑制，利多卡因血浓度增加，可发生心脏和神经系统不良反应，应调整利多卡因剂量，并应心电图监护及监测利多卡因血药浓度；(2)巴比妥类药物可促进利多卡因代谢，两药合用可引起心动过缓，窦性停搏；(3)与普鲁卡因胺合用，可产生一过性谵妄及幻觉，但不影响利多卡因血药浓度；(4)异丙基肾上腺素因增加肝血流量，可使利多卡因的总清除率升高；去甲肾上腺素因减少肝血流量，可使利多卡因总清除率下降；(5)与下列药品有配伍禁忌：苯巴比妥，硫喷妥钠，硝普钠，甘露醇，两性霉素B，氨苄西林，磺胺嘧啶
依诺沙星	华法林	药效提高，不良反应增加	依诺沙星与抗凝血药华法林合用时可增强可增强后者的抗凝作用，故应避免二者合用
氯唑西林	氨基糖苷类	药效降低，不良反应增加	氯唑西林与氨基糖苷类、去甲肾上腺素、间羟胺、苯巴比妥、维生素B族、维生素C等药物存在配伍禁忌，不宜同瓶滴注
氨咖敏	阿托品	不良反应增加	奎尼丁与氨咖敏同用，其类似阿托品样的效应加剧
复方头孢克洛胶囊	氨基糖苷类抗生素	不良反应增加	呋塞米、依他尼酸、布美他尼等强利尿药，卡氮芥、链佐星等抗肿瘤药及氨基糖苷类抗生素等肾毒性药物与复方头孢克洛胶囊合用有增加肾毒性的可能
利多卡因葡萄糖	纳多洛尔	药效提高，不良反应增加	与西咪替丁以及b受体阻断剂如，普萘洛尔、美托洛尔、纳多洛尔合用，利多卡因经肝脏代谢受抑制，利多卡因血浓度增加，可发生心脏和神经系统不良反应，应调整利多卡因剂量，并应心电图监护及监测利多卡因血药浓度；（2）巴比妥类药物可促进利多卡因代谢，两药合用可引起心动过缓，窦性停搏；（3）与普鲁卡因胺合用，可产生一过性谵妄及幻觉，但不影响利多卡因葡萄糖血药浓度；（4）异丙基肾上腺素因增加肝血流量，可使利多卡因葡萄糖的总清除率升高；去甲肾上腺素因减少肝血流量，可使利多卡因葡萄糖总清除率下降；（5）与下列药品有配伍禁忌：苯巴比妥，硫喷妥钠，硝普钠，甘露醇，两性霉素B，氨苄西林，磺胺嘧啶
氨溴索	头孢呋辛	药效提高，不良反应增加	氨溴索与抗生素同时服用（阿莫西林、头孢呋辛、红霉素、强力霉素）可导致抗生素在肺组织浓度升高，与其他药物合用所导致临床相关不良影响未见报道
注射用帕米膦酸二钠	沙利度胺	不良反应增加	当注射用帕米膦酸二钠与沙利度胺合用治疗多发性骨髓瘤时，发生肾功能恶化风险增加
奎宁	琥珀胆碱	不良反应增加	酸药及含铝制剂能延缓或减少奎宁的吸收；②抗凝药与奎宁合用后，抗凝作用可增强；③肌肉松弛药如琥珀胆碱、筒箭毒碱等与奎宁合同，可能会引起呼吸抑制；④奎尼丁与奎宁合用，金鸡纳反应可增加；⑤尿液碱化剂如碳酸氢钠等，可增加肾小管对奎宁的重吸收，导致奎宁血药浓度与毒性的增加；⑥与维生素K合用可增加奎宁的吸收；⑦与布克利嗪、赛克利嗪、美克利嗪、吩噻嗪类、噻吨类、曲美苄胺（trimethofenzamide）、氨基苷类抗生素合用可导致耳鸣、眩晕；⑧与硝苯地平（硝苯啶）合用，游离的奎宁浓度增加
肌苷氯化钠注射液	维生素B12	药效降低，不良反应增加	肌苷氯化钠注射液禁与下列注射液配伍：乳清酸、氯霉素、双嘧达莫、盐酸山梗菜碱、硫酸阿托品、氢溴酸东莨菪碱、盐酸氯丙嗪、盐酸异丙嗪、马来酸麦角新碱、盐酸普鲁卡因、硫喷妥钠、苯妥英钠、氯氮卓、盐酸去甲肾上腺素、盐酸丁卡因、利血平、硝普钠、降压嗪、呋噻米、利尿酸钠、促皮质素、维生素B12、盐酸苯海拉明、马来酸氯苯那敏、细胞色素C、盐酸万古霉素、盐酸四环素、二盐酸奎宁、盐酸阿糖胞苷、硫酸长春新碱以及所有菌苗和疫苗
头孢米诺	氢化可的松	药效降低，不良反应增加	本口与氨茶碱、磷酸吡哆醛配伍会降低效价或着色，故不得配伍；与呋喃硫胺、硫辛酸，氢化可的松琥珀酸钠及腺苷钴胺配伍后时间稍长会变色，故配伍后应尽快使用；与利尿剂呋(呋喃苯胺酸等)等合用有可能增加肾毒性，应谨慎使用，动物实验证实，头孢米诺影响酒精代谢，使血中乙醛浓度上升，显示双硫仑样作用，故用药期间或用药后应禁酒
富马酸福莫特罗粉吸入剂	β受体激动剂	不良反应增加	与其它拟交感神经药物合用会加重富马酸福莫特罗粉吸入剂的不良反应，β2-受体阻滞剂(包括滴眼药)，尤其是非选择性β受体阻滞剂，可能部分或完全抑制β受体激动剂
奎宁	抗凝药	不良反应增加	酸药及含铝制剂能延缓或减少奎宁的吸收；②抗凝药与奎宁合用后，抗凝作用可增强；③肌肉松弛药如琥珀胆碱、筒箭毒碱等与奎宁合同，可能会引起呼吸抑制；④奎尼丁与奎宁合用，金鸡纳反应可增加；⑤尿液碱化剂如碳酸氢钠等，可增加肾小管对奎宁的重吸收，导致奎宁血药浓度与毒性的增加；⑥与维生素K合用可增加奎宁的吸收；⑦与布克利嗪、赛克利嗪、美克利嗪、吩噻嗪类、噻吨类、曲美苄胺（trimethofenzamide）、氨基苷类抗生素合用可导致耳鸣、眩晕；⑧与硝苯地平（硝苯啶）合用，游离的奎宁浓度增加
头孢哌酮	利多卡因	药效降低，不良反应增加	头孢哌酮与复方乳酸钠注射液或盐酸利多卡因注射液混合后出现配伍禁忌
消旋卡多曲	酮康唑	药效提高，不良反应增加	红霉素、酮康唑等细胞色素酶P450-3A4抑制剂可能减少消旋卡多曲的代谢，增加毒性；
醋酸戈舍瑞林缓释植入剂	奎尼丁	不良反应增加	由于雄激素剥夺治疗可能延长QT间期，当醋酸戈舍瑞林缓释植入剂与已知可延长QT间期药物或可能会诱导尖端扭转型室性心动过速的药物如ⅠA类（如奎尼丁、丙吡胺）或Ⅲ类抗心律失常药物（如胺碘酮、索他洛尔、多非利特、伊布利特）、美沙酮、莫西沙星、抗精神病药物等合用时，应谨慎评估（详见【注意事项】）
卡那霉素	磺胺嘧啶	药效降低，不良反应增加	卡那霉素不宜与两性霉素B、头孢噻吩、磺胺嘧啶和四环素等注射剂联合应用，因可发生配伍禁忌
巴洛沙星	非甾体抗炎药	药效提高，不良反应增加	含有金属铝、镁的抗酸剂会干扰喹诺酮类药物的吸收，故不能与巴洛沙星同时服用；2.与非甾体抗炎药同时使用可能干扰巴洛沙星的吸收，增加痉挛发作的危险性；3.喹诺酮类药物与茶碱类合用时可能使血清中的茶碱水平升高，因此巴洛沙星与茶碱合用时应降低茶碱的剂量
布洛芬	甲氨喋呤	不良反应增加	合并用药时请注意下列事项：1.口服降糖药、甲氨喋呤、苯妥英、毛地黄、锂剂及饮酒等，可降低布洛芬耐受量
甘草酸二铵注射液	三氯甲噻嗪	药效提高，不良反应增加	与利尿酸、速尿、乙噻嗪、三氯甲噻嗪等利尿剂合用时，其利尿作用可增强甘草酸二铵注射液所含甘草酸二铵的排钾作用，宜导致血清钾值的下降，应特别注意观察血清钾值的测定
阿洛西林	丙磺舒	药效提高，不良反应增加	丙磺舒、阿司匹林、吲哚美辛、保泰松、磺胺药可减少阿洛西林自肾脏排泄，因此与阿洛西林合用时使其血药浓度增高，排泄时间延长，毒性也可能增加
利多卡因Ⅰ	两性霉素B	药效提高，不良反应增加	与西咪替丁以及b受体阻断剂如，普萘洛尔、美托洛尔、纳多洛尔合用，利多卡因经肝脏代谢受抑制，利多卡因血浓度增加，可发生心脏和神经系统不良反应，应调整利多卡因剂量，并应心电图监护及监测利多卡因血药浓度；（2）巴比妥类药物可促进利多卡因代谢，两药合用可引起心动过缓，窦性停搏；（3）与普鲁卡因胺合用，可产生一过性谵妄及幻觉，但不影响利多卡因Ⅰ血药浓度；（4）异丙基肾上腺素因增加肝血流量，可使利多卡因Ⅰ的总清除率升高；去甲肾上腺素因减少肝血流量，可使利多卡因Ⅰ总清除率下降；（5）与下列药品有配伍禁忌：苯巴比妥，硫喷妥钠，硝普钠，甘露醇，两性霉素B，氨苄西林，磺胺嘧啶
他克莫司	两性霉素B	不良反应增加	曾经观察到他克莫司和两性霉素B或布洛芬合并使用后增加肾毒性
利福平Ⅱ	达卡巴嗪	药效降低，不良反应增加	利福平Ⅱ可诱导肝微粒体酶，增加抗肿瘤药达卡巴嗪(dacarbazine)、环磷酰胺的代谢，形成烷化代谢物，促使白细胞减低，因此需调整剂量
达比加群	利伐沙班	不良反应增加	以下与达比加群联合使用时可能会增加出血风险的治疗缺乏经验或经验有限；抗凝药物如普通肝素（UFH）、低分子肝素（LMWH）、和肝素衍生物（磺达肝葵钠、地西卢定）、溶栓药物、维生素K拮抗剂、利伐沙班或其他口服抗凝药（参见【禁忌】），以及抗血小板聚集药物如GPIIb/IIIa受体拮抗剂、噻氯匹定、普拉格雷、替格瑞洛、右旋糖苷、磺吡酮（参见【注意事项】）
利多卡因Ⅰ	普萘洛尔	不良反应增加	与西咪替丁以及β受体阻断剂如，普萘洛尔、美托洛尔、纳多洛尔合用，利多卡因经肝脏代谢受抑制，利多卡因血浓度增加，可发生心脏和神经系统不良反应，应调整利多卡因剂量，并应心电图监护及监测利多卡因血药浓度；(2)巴比妥类药物可促进利多卡因代谢，两药合用可引起心动过缓，窦性停搏；(3)与普鲁卡因胺合用，可产生一过性谵妄及幻觉，但不影响利多卡因Ⅰ血药浓度；(4)异丙基肾上腺素因增加肝血流量，可使利多卡因Ⅰ的总清除率升高；去甲肾上腺素因减少肝血流量，可使利多卡因Ⅰ总清除率下降；(5)与下列药品有配伍禁忌：苯巴比妥，硫喷妥钠，硝普钠，甘露醇，两性霉素B，氨苄西林，磺胺嘧啶
利多卡因Ⅱ	甘露醇	药效提高，不良反应增加	与西咪替丁以及b受体阻断剂如，普萘洛尔、美托洛尔、纳多洛尔合用，利多卡因经肝脏代谢受抑制，利多卡因血浓度增加，可发生心脏和神经系统不良反应，应调整利多卡因剂量，并应心电图监护及监测利多卡因血药浓度；（2）巴比妥类药物可促进利多卡因代谢，两药合用可引起心动过缓，窦性停搏；（3）与普鲁卡因胺合用，可产生一过性谵妄及幻觉，但不影响利多卡因Ⅱ血药浓度；（4）异丙基肾上腺素因增加肝血流量，可使利多卡因Ⅱ的总清除率升高；去甲肾上腺素因减少肝血流量，可使利多卡因Ⅱ总清除率下降；（5）与下列药品有配伍禁忌：苯巴比妥，硫喷妥钠，硝普钠，甘露醇，两性霉素B，氨苄西林，磺胺嘧啶
小诺霉素	盐酸四环素	药效降低，不良反应增加	诺霉素不宜与两性霉素B、头孢噻吩钠、呋喃妥因钠、磺胺嘧啶钠和盐酸四环素等（以上均为注射液）联合应用，因可发生配伍禁忌
羧苄西林	两性霉素B	药效降低，不良反应增加	羧苄西林与琥珀氯霉素、琥乙红霉素、盐酸土霉素、盐酸四环素、卡那霉素、链霉素、庆大霉素、妥布霉素、两性霉素B、维生素B族、维生素C、苯妥英钠、拟交感类药物、异丙嗪等有配伍禁忌
利托那韦	普罗帕酮	不良反应增加	阿普唑仑、安非他酮、胺碘酮、阿咪唑、苄替地尔、西沙必利、氯拉折帕、氯氮平、右丙氧芬、地西泮、二氢麦角胺、恩卡肢、舒乐安定、麦角胺、氟卡胺、氟西泮、咪达唑仑、哌替啶、匹莫齐特、吡罗昔康、普罗帕酮、奎尼丁、利福布丁、特非那定、三唑仑和左吡登禁止用于利托那韦治疗的病人，因为它们可能与利托那韦发生相互作用，产生严重并发症的危险
洛伐他汀胶囊	抗凝药	药效提高，不良反应增加	洛伐他汀胶囊与口服抗凝药合用可使凝血酶原时间延长，使出血的危险性增加
消旋卡多曲	红霉素	药效提高，不良反应增加	红霉素、酮康唑等细胞色素酶P450-3A4抑制剂可能减少消旋卡多曲的代谢,增加毒性;
达比加群	磺吡酮	不良反应增加	以下与达比加群联合使用时可能会增加出血风险的治疗缺乏经验或经验有限；抗凝药物如普通肝素（UFH）、低分子肝素（LMWH）、和肝素衍生物（磺达肝葵钠、地西卢定）、溶栓药物、维生素K拮抗剂、利伐沙班或其他口服抗凝药（参见【禁忌】），以及抗血小板聚集药物如GPIIb/IIIa受体拮抗剂、噻氯匹定、普拉格雷、替格瑞洛、右旋糖苷、磺吡酮（参见【注意事项】）
氯胺酮	氟烷	不良反应增加	与氟烷等含卤全麻药同用时，氯胺酮的半衰期延长，苏醒延迟
洛匹那韦/利托那韦口服溶液	三唑仑	不良反应增加	阿普唑仑、安非他酮、胺碘酮、阿咪唑、苄替地尔、西沙必利、氯拉折帕、氯氮平、右丙氧芬、地西泮、二氢麦角胺、恩卡肢、舒乐安定、麦角胺、氟卡胺、氟西泮、咪达唑仑、哌替啶、匹莫齐特、吡罗昔康、普罗帕酮、奎尼丁、利福布丁、特非那定、三唑仑和左吡登禁止用于洛匹那韦/利托那韦口服溶液治疗的病人，因为它们可能与洛匹那韦/利托那韦口服溶液发生相互作用，产生严重并发症的危险
托特罗定	大环内酯类抗生素	药效提高，不良反应增加	不建议托特罗定与强效CYP3A4抑制剂，如大环内酯类抗生素（红霉素和克拉霉素）、抗真菌药（如酮康唑和伊曲康唑）和抗蛋白酶制剂联合用药，因为CYP2D6弱代谢者的托特罗定血清浓度可能升高，这将导致药物过量的风险
林可霉素	镇痛药	不良反应增加	与阿片类镇痛药合用，林可霉素的呼吸抑制作用与阿片类的中枢呼吸抑制作用可因累加现象而有导致呼吸抑制延长或引起呼吸麻痹（呼吸暂停）的可能，故必须对病人进行密切观察或监护
他克莫司	甲地孕酮	药效提高，不良反应增加	已知会抑制细胞色素P4503A4酶系统的药物：根据体外试验，下列药物可以视为他克莫司代谢的潜在性抑制剂：溴麦亭、可的松、氨苯砜、麦角胺、乙炔雌二醇、甲地孕酮、依他康唑、交沙霉素、利多卡因、甲妥因、咪康唑、尼卡地平、尼鲁地平、尼伐地平、炔诺酮、奎尼丁、他莫昔芬、三醋酸竹桃霉素、维拉帕米
利多卡因Ⅰ	巴比妥类	药效提高，不良反应增加	与西咪替丁以及β受体阻断剂如，普萘洛尔、美托洛尔、纳多洛尔合用，利多卡因经肝脏代谢受抑制，利多卡因血浓度增加，可发生心脏和神经系统不良反应，应调整利多卡因剂量，并应心电图监护及监测利多卡因血药浓度；(2)巴比妥类药物可促进利多卡因代谢，两药合用可引起心动过缓，窦性停搏；(3)与普鲁卡因胺合用，可产生一过性谵妄及幻觉，但不影响利多卡因Ⅰ血药浓度；(4)异丙基肾上腺素因增加肝血流量，可使利多卡因Ⅰ的总清除率升高；去甲肾上腺素因减少肝血流量，可使利多卡因Ⅰ总清除率下降；(5)与下列药品有配伍禁忌：苯巴比妥，硫喷妥钠，硝普钠，甘露醇，两性霉素B，氨苄西林，磺胺嘧啶
保泰松	氨苯蝶啶	不良反应增加	保泰松与利尿剂氨苯蝶啶合用可引起肾功能损害
复方对乙酰氨基酚Ⅱ	巴比妥类	不良反应增加	复方对乙酰氨基酚Ⅱ不应与含有酒精的饮料、巴比妥类（如苯巴比妥）、解痉药（如颠茄）同服，因可造成肝脏损害
达比加群	替格瑞洛	不良反应增加	以下与达比加群联合使用时可能会增加出血风险的治疗缺乏经验或经验有限；抗凝药物如普通肝素（UFH）、低分子肝素（LMWH）、和肝素衍生物（磺达肝葵钠、地西卢定）、溶栓药物、维生素K拮抗剂、利伐沙班或其他口服抗凝药（参见【禁忌】），以及抗血小板聚集药物如GPIIb/IIIa受体拮抗剂、噻氯匹定、普拉格雷、替格瑞洛、右旋糖苷、磺吡酮（参见【注意事项】）
咪康唑	西沙必利	药效降低，不良反应增加	咪康唑与西沙必利合用属禁忌，因合用时抑制细胞色素P450代谢通道，可导致心律紊乱
利多卡因Ⅰ	巴比妥类	药效提高，不良反应增加	与西咪替丁以及b受体阻断剂如，普萘洛尔、美托洛尔、纳多洛尔合用，利多卡因经肝脏代谢受抑制，利多卡因血浓度增加，可发生心脏和神经系统不良反应，应调整利多卡因剂量，并应心电图监护及监测利多卡因血药浓度；（2）巴比妥类药物可促进利多卡因代谢，两药合用可引起心动过缓，窦性停搏；（3）与普鲁卡因胺合用，可产生一过性谵妄及幻觉，但不影响利多卡因Ⅰ血药浓度；（4）异丙基肾上腺素因增加肝血流量，可使利多卡因Ⅰ的总清除率升高；去甲肾上腺素因减少肝血流量，可使利多卡因Ⅰ总清除率下降；（5）与下列药品有配伍禁忌：苯巴比妥，硫喷妥钠，硝普钠，甘露醇，两性霉素B，氨苄西林，磺胺嘧啶
双氢麦角毒碱	多巴胺	不良反应增加	多巴胺与双氢麦角毒碱联合应用时，可诱导周围血管痉挛，特别是肢体远端血管收缩
利多卡因Ⅱ	硝普钠	药效提高，不良反应增加	与西咪替丁以及β受体阻断剂如，普萘洛尔、美托洛尔、纳多洛尔合用，利多卡因经肝脏代谢受抑制，利多卡因血浓度增加，可发生心脏和神经系统不良反应，应调整利多卡因剂量，并应心电图监护及监测利多卡因血药浓度；(2)巴比妥类药物可促进利多卡因代谢，两药合用可引起心动过缓，窦性停搏；(3)与普鲁卡因胺合用，可产生一过性谵妄及幻觉，但不影响利多卡因Ⅱ血药浓度；(4)异丙基肾上腺素因增加肝血流量，可使利多卡因Ⅱ的总清除率升高；去甲肾上腺素因减少肝血流量，可使利多卡因Ⅱ总清除率下降；(5)与下列药品有配伍禁忌：苯巴比妥，硫喷妥钠，硝普钠，甘露醇，两性霉素B，氨苄西林，磺胺嘧啶
毛花苷丙	地高辛	药效提高，不良反应增加	奎尼丁同用，可使毛花苷丙血药浓度提高约一倍，提高程度与奎尼丁用量相关，甚至可达到中毒浓度，即使停用地高辛，其血药浓度仍继续上升，这是奎尼丁从组织结合处置换出地高辛，减少其分布容积之故
阿洛西林	保泰松	药效提高，不良反应增加	丙磺舒、阿司匹林、吲哚美辛、保泰松、磺胺药可减少阿洛西林自肾脏排泄，因此与阿洛西林合用时使其血药浓度增高，排泄时间延长，毒性也可能增加
妥布霉素	头孢噻吩	不良反应增加	妥布霉素与头孢噻吩合用可能增加肾毒性
肌苷氯化钠注射液	氢溴酸东莨菪碱	药效降低，不良反应增加	肌苷氯化钠注射液禁与下列注射液配伍：乳清酸、氯霉素、双嘧达莫、盐酸山梗菜碱、硫酸阿托品、氢溴酸东莨菪碱、盐酸氯丙嗪、盐酸异丙嗪、马来酸麦角新碱、盐酸普鲁卡因、硫喷妥钠、苯妥英钠、氯氮卓、盐酸去甲肾上腺素、盐酸丁卡因、利血平、硝普钠、降压嗪、呋噻米、利尿酸钠、促皮质素、维生素B12、盐酸苯海拉明、马来酸氯苯那敏、细胞色素C、盐酸万古霉素、盐酸四环素、二盐酸奎宁、盐酸阿糖胞苷、硫酸长春新碱以及所有菌苗和疫苗
辛伐他汀	吉非贝齐	不良反应增加	辛伐他汀与羟甲基戊二酰辅酶A（HMG-COA）还原酶抑制剂合并用药会增加肌病的发生率和严重程度，这些药包括吉非贝齐和其他贝特类，以及降脂剂量的烟酸（大于等于1g/d）
青霉素	保泰松	药效提高，不良反应增加	阿司匹林、吲哚美辛、保泰松、磺胺药可减少青霉素在肾小管的排泄，因而可使青霉素的血药浓度升高，而且维持较久，血清半衰期延长，毒性也可能增加
头孢哌酮	镁	药效降低，不良反应增加	头孢哌酮与下列药物注射剂有配伍禁忌：阿米卡星、庆大霉素、卡那霉素B、多西环素、甲氯芬酯、阿马林(缓脉灵)、苯海拉明、门冬酸钾镁、盐酸羟嗪(安太乐)、普鲁卡因胺、氨茶碱、丙氯拉嗪、细胞色素C、喷他佐辛(镇痛新)、抑肽酶等
羧苄西林	琥乙红霉素	药效降低，不良反应增加	羧苄西林与琥珀氯霉素、琥乙红霉素、盐酸土霉素、盐酸四环素、卡那霉素、链霉素、庆大霉素、妥布霉素、两性霉素B、维生素B族、维生素C、苯妥英钠、拟交感类药物、异丙嗪等有配伍禁忌
氯喹	肝素	不良反应增加	氯喹对神经肌肉接头有直接抑制作用，链霉素可加重此不良反应.4.洋地黄化后应用氯喹易引起心脏传导阻滞.5.氯喹与肝素或青霉胺合用，可增加出血机会
洛匹那韦/利托那韦口服溶液	舒乐安定	不良反应增加	阿普唑仑、安非他酮、胺碘酮、阿咪唑、苄替地尔、西沙必利、氯拉折帕、氯氮平、右丙氧芬、地西泮、二氢麦角胺、恩卡肢、舒乐安定、麦角胺、氟卡胺、氟西泮、咪达唑仑、哌替啶、匹莫齐特、吡罗昔康、普罗帕酮、奎尼丁、利福布丁、特非那定、三唑仑和左吡登禁止用于洛匹那韦/利托那韦口服溶液治疗的病人，因为它们可能与洛匹那韦/利托那韦口服溶液发生相互作用，产生严重并发症的危险
罗红霉素	双氢麦角胺	不良反应增加	罗红霉素与麦角胺和双氢麦角胺同时服用能造成血液循环障碍（特别是手指和脚趾），不可同时服用
妥布霉素氯化钠	头孢噻吩	不良反应增加	妥布霉素氯化钠与头孢噻吩合用可能增加肾毒性
氨苄西林	别嘌醇	不良反应增加	别嘌醇：有报道，合用氨苄西林与别嘌醇的患者较单用氨苄西林者，皮疹发生率明显升高
布洛芬	抗凝药	药效提高，不良反应增加	布洛芬与肝素、双香豆素等抗凝药同用时，可导致凝血酶原时间延长，增加出血倾向，不宜同用
氧	去甲肾上腺素	药效降低，不良反应增加	氧与氨基糖苷类、去甲肾上腺素、间羟胺、苯巴比妥、维生素B族、维生素C等药物存在配伍禁忌，不宜同瓶滴注
氟西泮	抗高血压药	药效提高，不良反应增加	氟西泮与抗高血压药或与利尿降压药合用时，可使降压作用增强
利福平Ⅱ	抗肿瘤药	药效降低，不良反应增加	利福平Ⅱ可诱导肝微粒体酶，增加抗肿瘤药达卡巴嗪(dacarbazine)、环磷酰胺的代谢，形成烷化代谢物，促使白细胞减低，因此需调整剂量
托拉塞米	抗生素	不良反应增加	可加强氨基糖甙类抗生素（如卡那霉素、庆大霉素、妥布霉素）、抑制细胞增殖的铂衍生物和头孢菌素的耳毒性和肾脏毒性效应，特别是大剂量托拉塞米治疗时；
苯海索	帕吉林	药效提高，不良反应增加	苯海索与金刚烷胺、抗胆碱药、单胺氧化酶抑制药帕吉林及丙卡巴肼合用时，可加强抗胆碱作用，并可发生麻痹性肠梗阻
更昔洛韦	氟胞嘧啶	不良反应增加	抑制高分裂相细胞(骨髓、精原细胞、皮肤和胃肠道粘膜生发层)复制的药物(氨苯砜、喷他脒、氟胞嘧啶、长春新碱、长春花碱、阿霉素、两性霉素B、甲氧苄啶/磺胺恶唑或其他核苷类)与更昔洛韦合用时毒性增加
芬太尼	红霉素	药效提高，不良反应增加	但实验资料表明CYP3A4抑制剂，如红霉素、酮康唑、伊曲康唑和tironavir会抑制舒芬太尼的代谢从而延长呼吸抑制作用
富马酸比索洛尔片	麦角胺	不良反应增加	富马酸比索洛尔片与麦角胺类衍生物(如含有麦角胺的抗偏头痛药物)合用时可能会增加外周循环的阻力
头孢哌酮	普鲁卡因胺	药效降低，不良反应增加	头孢哌酮与下列药物注射剂有配伍禁忌：阿米卡星、庆大霉素、卡那霉素B、多西环素、甲氯芬酯、阿马林(缓脉灵)、苯海拉明、门冬酸钾镁、盐酸羟嗪(安太乐)、普鲁卡因胺、氨茶碱、丙氯拉嗪、细胞色素C、喷他佐辛(镇痛新)、抑肽酶等
肝素	双嘧达莫	药效提高，不良反应增加	（l）肝素与下列药物合用，可加重出血危险：①香豆素及其衍生物，可导致严重的因子Ⅸ缺乏而致出血；②阿司匹林及非甾体消炎镇痛药，包括甲芬那酸、水杨酸等均能抑制血小板功能，并能诱发胃肠道溃疡出血；③双嘧达莫、右旋糖酐等可能抑制血小板功能；④肾上腺皮质激素、促肾上腺皮质激素等易诱发胃肠道溃疡出血；⑤其他尚有利尿酸、组织纤溶酶原激活物（t-PA）、尿激酶、链激酶等
甘草酸二铵葡萄糖注射液	速尿	药效提高，不良反应增加	与利尿酸、速尿、乙噻嗪、三氯甲噻嗪等利尿剂并用时，其利尿作用可增强甘草酸二铵葡萄糖注射液中所含甘草酸二铵的排钾作用，易导致血清钾的下降，应特别注意观察血清钾值的测定等
环孢素	阿托伐他汀	不良反应增加	从文献和上市后搜集的肌肉毒性病例来看，肌肉毒性包括肌痛、肌无力、肌炎、横纹肌溶解，与环孢素合并使用的药物包括洛伐他汀、辛伐他汀、阿托伐他汀、普伐他汀，与氟伐他汀合用时引起肌肉毒性的病例较为罕见
奥硝唑	呋布西林	药效降低，不良反应增加	奥硝唑与呋布西林钠、萘夫西林钠、奥美拉唑、沃必唑、注射用炎琥宁、阿洛西林钠存在配伍禁忌
异甘草酸镁注射液	呋塞米	药效提高，不良反应增加	与依他尼酸、呋塞米等噻嗪类及三氯甲噻嗪、氯噻酮等降压利尿剂并用时，其利尿作用可增强异甘草酸镁注射液的排钾作用，易导致血清钾值的下降，应注意观察血清钾值的测定等
奈韦拉平	美沙酮	不良反应增加	据报道，同时应用奈韦拉平和美沙酮治疗的患者曾出现戒断综合征
氯霉素	雌激素	药效降低，不良反应增加	长期口服含雌激素的避孕药与氯霉素同用，可使避孕的可靠性降低，以及经期外出血增加
阿立哌唑	伊曲康唑	药效提高，不良反应增加	预期其他CYP3A4的强抑制剂（伊曲康唑）有相似的作用，也需相应的降低剂量；当停止联合治疗中的CYP3A4抑制剂时，阿立哌唑的剂量应增加
双氯芬酸Ⅴ	甲氨喋呤	药效提高，不良反应增加	双氯芬酸Ⅴ可降低甲氨蝶呤的排泄，增高其血浓度，甚至可达中毒水平，故双氯芬酸Ⅴ不应与中或大剂量甲氨喋呤同用
酮洛芬Ⅱ	丙磺舒	药效提高，不良反应增加	酮洛芬Ⅱ不应与丙磺舒同用，因后者可明显降低酮洛芬Ⅱ肾脏清除率（降低66%）和蛋白结合率（降低28％），导致血药浓度增高，而有引起中毒的危险
苯海索	金刚烷胺	药效提高，不良反应增加	苯海索与金刚烷胺、抗胆碱药、单胺氧化酶抑制药帕吉林及丙卡巴肼合用时，可加强抗胆碱作用，并可发生麻痹性肠梗阻
利多卡因Ⅰ	西咪替丁	药效降低，不良反应增加	与西咪替丁以及β受体阻断剂如，普萘洛尔、美托洛尔、纳多洛尔合用，利多卡因经肝脏代谢受抑制，利多卡因血浓度增加，可发生心脏和神经系统不良反应，应调整利多卡因剂量，并应心电图监护及监测利多卡因血药浓度；(2)巴比妥类药物可促进利多卡因代谢，两药合用可引起心动过缓，窦性停搏；(3)与普鲁卡因胺合用，可产生一过性谵妄及幻觉，但不影响利多卡因Ⅰ血药浓度；(4)异丙基肾上腺素因增加肝血流量，可使利多卡因Ⅰ的总清除率升高；去甲肾上腺素因减少肝血流量，可使利多卡因Ⅰ总清除率下降；(5)与下列药品有配伍禁忌：苯巴比妥，硫喷妥钠，硝普钠，甘露醇，两性霉素B，氨苄西林，磺胺嘧啶
复方碳酸钙泡腾颗粒	噻嗪类利尿药	药效提高，不良反应增加	复方碳酸钙泡腾颗粒与噻嗪类利尿药合用时，因增加肾小管对钙的重吸收而易发生高钙血症
西咪替丁	氨茶碱	药效提高，不良反应增加	西咪替丁与茶碱、咖啡因、氨茶碱等黄嘌呤类药配伍用时，肝代谢降低，可导致清除延缓，血药浓度升高，可能发生中毒反应
普萘洛尔	利托那韦	药效提高，不良反应增加	与CYP2D6酶底物或抑制剂，例如胺碘酮，西咪替丁，地拉韦啶，氟西汀，帕罗西汀，奎尼丁和利托那韦合用，可增加普萘洛尔的血浓度和/或毒性
利多卡因Ⅰ	美托洛尔	药效提高，不良反应增加	与西咪替丁以及b受体阻断剂如，普萘洛尔、美托洛尔、纳多洛尔合用，利多卡因经肝脏代谢受抑制，利多卡因血浓度增加，可发生心脏和神经系统不良反应，应调整利多卡因剂量，并应心电图监护及监测利多卡因血药浓度；（2）巴比妥类药物可促进利多卡因代谢，两药合用可引起心动过缓，窦性停搏；（3）与普鲁卡因胺合用，可产生一过性谵妄及幻觉，但不影响利多卡因Ⅰ血药浓度；（4）异丙基肾上腺素因增加肝血流量，可使利多卡因Ⅰ的总清除率升高；去甲肾上腺素因减少肝血流量，可使利多卡因Ⅰ总清除率下降；（5）与下列药品有配伍禁忌：苯巴比妥，硫喷妥钠，硝普钠，甘露醇，两性霉素B，氨苄西林，磺胺嘧啶
阿咖	酒精	不良反应增加	阿咖不应与含有酒精的饮料、巴比妥类(如苯巴比妥)、解痉药类(如颠茄)同服，因可造成肝损害
阿莫西林	吲哚美辛	药效提高，不良反应增加	司匹林、吲哚美辛、保泰松、磺胺药可减少阿莫西林在肾小管的排泄，因而使阿莫西林的血药浓度升高，血消除半衰期（t1/2）延长，毒性也可能增加
复方间苯二酚水杨酸酊	过氧苯甲酰	不良反应增加	复方间苯二酚水杨酸酊与肥皂、清洁剂、痤疮制剂如过氧苯甲酰、硫黄、维A酸等同用，会增加刺激性或干燥作用
对乙酰氨基酚	苯巴比妥	不良反应增加	应用巴比妥类(如苯巴比妥)或解痉药（如颠茄）的患者，长期应用对乙酰氨基酚可致肝损害
茶碱Ⅱ	克林霉素	药效提高，不良反应增加	与克林霉素、林可霉素及某些大环内酯类（红霉素、罗红霉素、克拉霉素）、喹诺酮类抗菌药（依诺沙星、环丙沙星）合用时，可降低茶碱Ⅱ在肝脏的代谢，血药浓度升高，甚至出现毒性，应在给药前后调整茶碱Ⅱ的用量
头孢丙烯	氨基糖苷类抗生素	药效提高，不良反应增加	已有氨基糖苷类抗生素和头孢菌素合用引起肾毒性的报道，与丙磺舒合用使头孢丙烯的AUC增加一倍
复方碳酸钙颗粒	噻嗪类利尿药	药效提高，不良反应增加	复方碳酸钙颗粒与噻嗪类利尿药合用时，因增加肾小管对钙的重吸收而易发生高钙血症
萘夫西林	维生素C	药效降低，不良反应增加	萘夫西林与氨基糖苷类、去甲肾上腺素、间羟胺、苯巴比妥、维生素B族、维生素C等药物存在配伍禁忌，不宜同瓶滴注
别嘌醇	巯嘌呤	药效提高，不良反应增加	别嘌醇与硫唑嘌呤或巯嘌呤同用时，因别嘌醇能抑制黄嘌呤氧化酶而延长硫唑嘌呤或巯嘌呤的半衰期，使其疗效增加2-4倍，毒性增大，故硫唑嘌呤或巯嘌呤的用量一般要减少至常用量的1/4～1/3
异甘草酸镁注射液	噻嗪类	药效提高，不良反应增加	与依他尼酸、呋塞米等噻嗪类及三氯甲噻嗪、氯噻酮等降压利尿剂并用时，其利尿作用可增强异甘草酸镁注射液的排钾作用，易导致血清钾值的下降，应注意观察血清钾值的测定等
阿扎司琼	氟尿嘧啶	药效降低，不良反应增加	阿扎司琼与碱性注射液(如呋喃苯胺酸、甲氯蝶呤、氟尿嘧啶，吡咯他尼等注射液)或鬼臼乙叉甙注射液配伍会发生浑浊或结晶析出，故需将阿扎司琼先用氯化钠注射液稀释后，方可与上述碱性药物配伍使用
酮洛芬Ⅱ	甲氨蝶呤	药效提高，不良反应增加	酮洛芬Ⅱ可降低甲氨蝶呤的排泄，增高其血药浓度，甚至可达中毒水平，故酮洛芬Ⅱ不应与中或大剂量甲氨蝶呤疗法同用
普萘洛尔	环丙沙星	药效提高，不良反应增加	与CYP1A2酶底物或抑制剂合用，例如丙咪嗪、西咪替丁、环丙沙星、伏沙明、异烟肼、利托那韦、茶碱、齐留通、佐米曲普坦和利扎曲坦，可增加普萘洛尔的血浓度和/或毒性
利多卡因	美托洛尔	药效提高，不良反应增加	与西咪替丁以及β-受体阻断剂如，普萘洛尔、美托洛尔、纳多洛尔合用，利多卡因经肝脏代谢受抑制，利多卡因血浓度增加，可发生心脏和神经系统不良反应，应调整利多卡因剂量，并应心电图监护及监测利多卡因血药浓度
达比加群	磺达肝葵钠	不良反应增加	以下与达比加群联合使用时可能会增加出血风险的治疗缺乏经验或经验有限；抗凝药物如普通肝素（UFH）、低分子肝素（LMWH）、和肝素衍生物（磺达肝葵钠、地西卢定）、溶栓药物、维生素K拮抗剂、利伐沙班或其他口服抗凝药（参见【禁忌】），以及抗血小板聚集药物如GPIIb/IIIa受体拮抗剂、噻氯匹定、普拉格雷、替格瑞洛、右旋糖苷、磺吡酮（参见【注意事项】）
比伐芦定	抗凝药	不良反应增加	从药物作用机理可知，比伐芦定与抗凝药物（肝素、华法林、血小板球蛋白或血小板抑制剂）联合用药可能会增加出血的危险，在任何情况下，当比伐芦定与血小板抑制剂或抗凝药物联合用药时，要经常监测临床和生物学的凝血参数
复方愈创木酚磺酸钾口服溶液	催眠药	不良反应增加	与乙醇、镇静、催眠药、抗过敏药并用可增加复方愈创木酚磺酸钾口服溶液对中枢的抑制作用
布洛芬	口服降糖药	不良反应增加	口服降糖药、甲氨喋呤、苯妥英、毛地黄、锂剂及饮洒等可降低布洛芬耐受量
利多卡因葡萄糖	硫喷妥钠	药效提高，不良反应增加	与西咪替丁以及b受体阻断剂如，普萘洛尔、美托洛尔、纳多洛尔合用，利多卡因经肝脏代谢受抑制，利多卡因血浓度增加，可发生心脏和神经系统不良反应，应调整利多卡因剂量，并应心电图监护及监测利多卡因血药浓度；（2）巴比妥类药物可促进利多卡因代谢，两药合用可引起心动过缓，窦性停搏；（3）与普鲁卡因胺合用，可产生一过性谵妄及幻觉，但不影响利多卡因葡萄糖血药浓度；（4）异丙基肾上腺素因增加肝血流量，可使利多卡因葡萄糖的总清除率升高；去甲肾上腺素因减少肝血流量，可使利多卡因葡萄糖总清除率下降；（5）与下列药品有配伍禁忌：苯巴比妥，硫喷妥钠，硝普钠，甘露醇，两性霉素B，氨苄西林，磺胺嘧啶
利多卡因	磺胺嘧啶	药效提高，不良反应增加	与西咪替丁以及b受体阻断剂如，普萘洛尔、美托洛尔、纳多洛尔合用，利多卡因经肝脏代谢受抑制，利多卡因血浓度增加，可发生心脏和神经系统不良反应，应调整利多卡因剂量，并应心电图监护及监测利多卡因血药浓度；（2）巴比妥类药物可促进利多卡因代谢，两药合用可引起心动过缓，窦性停搏；（3）与普鲁卡因胺合用，可产生一过性谵妄及幻觉，但不影响利多卡因血药浓度；（4）异丙基肾上腺素因增加肝血流量，可使利多卡因的总清除率升高；去甲肾上腺素因减少肝血流量，可使利多卡因总清除率下降；（5）与下列药品有配伍禁忌：苯巴比妥，硫喷妥钠，硝普钠，甘露醇，两性霉素B，氨苄西林，磺胺嘧啶
达比加群	利福平	药效提高，不良反应增加	预计与P-gp诱导物（如：利福平、贯叶连翘（金丝桃）、卡马西平、或苯妥英等）联合使用会降低达比加群血药浓度，因此应该避免联合使用（参见【注意事项】和【药代动力学】）
复方柳安咖	双香豆素	药效提高，不良反应增加	复方柳安咖与双香豆素合用时，因从血浆蛋白结合部置换后者，提高游离型双香豆素血浓度，增强其抗凝作用，易致出血
利福平Ⅱ	地西泮	不良反应增加	利福平Ⅱ与地西泮(安定)合用可使肝毒性反应增加
奎宁	碳酸氢钠	药效提高，不良反应增加	液碱化剂如碳酸氢钠等，可增加肾小管对奎宁的重吸收，导致奎宁血药浓度与毒性的增加;
舒巴坦	保泰松	药效提高，不良反应增加	丙磺舒、阿斯匹林、吲哚美辛、保泰松、磺胺等药物可减少舒巴坦自肾排泄，因此与舒巴坦合用时使其血药浓度增高，排泄时间延长，毒性也可能增加
利福平	酮康唑	不良反应增加	异烟肼与利福平或咪康唑(静脉)、酮康唑合用可增加肝毒性发生的危险，尤其是原有肝功能损害者和异烟肼快乙酰化患者
利福平滴眼液	环磷酰胺	药效降低，不良反应增加	利福平滴眼液可诱导肝微粒体酶，增加抗肿瘤药达卡巴嗪(dacarbazine)﹑环磷酰胺的代谢，形成烷化代谢物，促使白细胞减低，因此需调整剂量
沙美特罗	酮康唑	药效提高，不良反应增加	酮康唑和SEREVENT（有效成分为沙美特罗）合用时将会导致血浆中沙美特罗的暴露量明显增加(Cmax的1.4倍，AUC的15倍)，这可能引起心电图QTc间期延长(参见【注意事项】及【药代动力学】)
舒巴坦	抗生素	药效降低，不良反应增加	舒巴坦与氨基糖甙类抗生素有协同作用，但二者有配伍禁忌，如需并用，应分别溶解稀释后输注
利托那韦口服溶液	右丙氧芬	不良反应增加	阿普唑仑、安非他酮、胺碘酮、阿咪唑、苄替地尔、西沙必利、氯拉折帕、氯氮平、右丙氧芬、地西泮、二氢麦角胺、恩卡肢、舒乐安定、麦角胺、氟卡胺、氟西泮、咪达唑仑、哌替啶、匹莫齐特、吡罗昔康、普罗帕酮、奎尼丁、利福布丁、特非那定、三唑仑和左吡登禁止用于利托那韦口服溶液治疗的病人，因为它们可能与利托那韦口服溶液发生相互作用，产生严重并发症的危险
肝素	甲芬那酸	药效提高，不良反应增加	（l）肝素与下列药物合用，可加重出血危险：①香豆素及其衍生物，可导致严重的因子Ⅸ缺乏而致出血；②阿司匹林及非甾体消炎镇痛药，包括甲芬那酸、水杨酸等均能抑制血小板功能，并能诱发胃肠道溃疡出血；③双嘧达莫、右旋糖酐等可能抑制血小板功能；④肾上腺皮质激素、促肾上腺皮质激素等易诱发胃肠道溃疡出血；⑤其他尚有利尿酸、组织纤溶酶原激活物（t-PA）、尿激酶、链激酶等
氯霉素	雌激素	药效降低，不良反应增加	长期口服含雌激素的避孕药者同时服用氯霉素时，可使避孕的可靠性降低，以及经期外出血增加
维生素D2	利尿药	不良反应增加	大量钙剂或利尿药与常用量维生素D2并用，有发生高钙血症的危险
咖啡因	保泰松	药效提高，不良反应增加	与抗凝剂如香豆素类或氯霉素、异烟肼、保泰松、磺胺类合用，可减低咖啡因的代谢，可能增加咖啡因的毒性
硫酸特布他林雾化液	糖皮质激素	不良反应增加	由于β受体激动剂的低钾血症作用，应在仔细评估药物效益与风险后，尤其是低钾血症导致心律失常等风险增加，谨慎合用硫酸特布他林雾化液和利尿剂、甲基黄嘌呤和糖皮质激素等增加低钾血症风险的钾消耗剂（参见【注意事项】）
瑞舒伐他汀	华法林	不良反应增加	维生素K拮抗剂：同其它HMG-CoA还原酶抑制剂一样，对同时使用维生素K拮抗剂（如：华法林）的患者，开始使用瑞舒伐他汀或逐渐增加瑞舒伐他汀剂量可能导致INR升高
别嘌醇	硫唑嘌呤	药效提高，不良反应增加	别嘌醇与硫唑嘌呤或巯嘌呤同用时，因别嘌醇能抑制黄嘌呤氧化酶而延长硫唑嘌呤或巯嘌呤的半衰期，使其疗效增加2-4倍，毒性增大，故硫唑嘌呤或巯嘌呤的用量一般要减少至常用量的1/4～1/3
去乙酰毛花苷	地高辛	药效提高，不良反应增加	与奎尼丁同用，可使去乙酰毛花苷血药浓度提高约一倍，提高程度与奎尼丁用量相关，甚至可达到中毒浓度，即使停用地高辛，其血药浓度仍继续上升，这是奎尼丁从组织结合处置换出地高辛，减少其分布容积之故
利多卡因Ⅰ	去甲肾上腺素	药效提高，不良反应增加	与西咪替丁以及b受体阻断剂如，普萘洛尔、美托洛尔、纳多洛尔合用，利多卡因经肝脏代谢受抑制，利多卡因血浓度增加，可发生心脏和神经系统不良反应，应调整利多卡因剂量，并应心电图监护及监测利多卡因血药浓度；（2）巴比妥类药物可促进利多卡因代谢，两药合用可引起心动过缓，窦性停搏；（3）与普鲁卡因胺合用，可产生一过性谵妄及幻觉，但不影响利多卡因Ⅰ血药浓度；（4）异丙基肾上腺素因增加肝血流量，可使利多卡因Ⅰ的总清除率升高；去甲肾上腺素因减少肝血流量，可使利多卡因Ⅰ总清除率下降；（5）与下列药品有配伍禁忌：苯巴比妥，硫喷妥钠，硝普钠，甘露醇，两性霉素B，氨苄西林，磺胺嘧啶
青霉素	苯巴比妥	药效降低，不良反应增加	青霉素与氨基糖苷类、去甲肾上腺素、间羟胺、苯巴比妥、维生素B族、维生素C等药物存在配伍禁忌，不宜同瓶滴注
溴丙胺太林	阿托品	不良反应增加	奎尼丁和溴丙胺太林同用，其类似阿托品样的效应加重
维生素B6	肾上腺皮质激素	不良反应增加	6．氯霉类、坏丝氨酸、乙硫异烟胺、盐酸肼酞嗪、免疫抑制剂包括肾上腺皮质激素、环磷酰胺、环孢素、异烟肼、青霉胺等药物可拮抗维生素B6或增加维生素B6经肾排泄，可引起贫血或周围神经炎
头孢呋辛	呋塞米	不良反应增加	呋塞米、依他尼酸、布美他尼等强利尿药、卡氮芥、链佐星等抗肿瘤药以及氨基糖苷类抗生素与头孢呋辛合用有增加肾毒性的可能
阿莫西林	阿司匹林	药效提高，不良反应增加	阿司匹林、吲哚美辛、保泰松、磺胺药可减少阿莫西林在肾小管的排泄，因而可使阿莫西林的血药浓度升高，而且维持较久，血清半衰期延长，毒性也可能增加
洛美沙星	丙磺舒	药效提高，不良反应增加	丙磺舒可延迟洛美沙星的排泄，使平均曲线下面积（AUC）增大63%，平均达峰时间(tmax)延长50%，平均峰浓度(Cmax)增高4%，故合用时可因洛美沙星血浓度增高而产生毒性
林可霉素	镇痛药	不良反应增加	与阿片类镇痛药合用，林可霉素的呼吸抑制作用与阿片类的中枢呼吸抑制作用可因累加现象而有导致呼吸抑制延长或引起呼吸麻痹(呼吸暂停)的可能，故必须对病人进行密切观察或监护
氟康唑	环磷酰胺	不良反应增加	环磷酰胺：环磷酰胺与氟康唑联合用药可导致血胆红素和血肌酐浓度升高
阿莫西林克拉维酸钾	别嘌呤醇	不良反应增加	虽然尚无阿莫西林克拉维酸钾与别嘌呤醇合用的资料，但阿莫西林与别嘌呤酵合用可增加过敏性皮肤反应的可能性
洛匹那韦/利托那韦口服溶液	匹莫齐特	不良反应增加	阿普唑仑、安非他酮、胺碘酮、阿咪唑、苄替地尔、西沙必利、氯拉折帕、氯氮平、右丙氧芬、地西泮、二氢麦角胺、恩卡肢、舒乐安定、麦角胺、氟卡胺、氟西泮、咪达唑仑、哌替啶、匹莫齐特、吡罗昔康、普罗帕酮、奎尼丁、利福布丁、特非那定、三唑仑和左吡登禁止用于洛匹那韦/利托那韦口服溶液治疗的病人，因为它们可能与洛匹那韦/利托那韦口服溶液发生相互作用，产生严重并发症的危险
利多卡因	西咪替丁	药效提高，不良反应增加	与西咪替丁以及β-受体阻断剂如，普萘洛尔、美托洛尔、纳多洛尔合用，利多卡因经肝脏代谢受抑制，利多卡因血浓度增加，可发生心脏和神经系统不良反应，应调整利多卡因剂量，并应心电图监护及监测利多卡因血药浓度
洛美沙星氯化钠	丙磺舒	药效提高，不良反应增加	丙磺舒可延迟洛美沙星氯化钠的排泄，使平均曲线下面积（AUC）增大63%，平均达峰时间（tmax延长50%，平均峰浓度（Cmax）增高4%；故合用时可因洛美沙星氯化钠血浓度增高而产生毒性
利多卡因	普萘洛尔	药效提高，不良反应增加	与西咪替丁以及与受体阻滞剂如，普萘洛尔、美托洛尔、纳多洛尔合用，利多卡因经肝脏代谢受抑制，利多卡因血浓度增加，可发生心脏和神经系统不良反应
奎宁	琥珀胆碱	不良反应增加	肉松弛药如琥珀胆碱、筒箭毒碱等与奎宁合同，可能会引起呼吸抑制；
对乙酰氨基酚	巴比妥类	不良反应增加	对乙酰氨基酚不应与含有酒精的饮料、巴比妥类(如苯巴比妥)、解痉药类(如颠茄)同服，因可造成肝损害
双嘧达莫	肝素	药效提高，不良反应增加	双嘧达莫与肝素、双香豆素类抗凝药、头孢孟多、头孢替坦、普卡霉素或丙戊酸等合用时，可加重低凝血酶原血症或进一步抑制血小板聚集，有引起出血的危险，需加强观察
维生素K	苯妥英钠	药效降低，不良反应增加	维生素K与苯妥英钠混合2小时后可出现颗粒沉淀，与维生素C、维生素B12、右旋糖酐混合易出现混浊
青霉素	维生素C	药效降低，不良反应增加	青霉素与氨基糖苷类、去甲肾上腺素、间羟胺、苯巴比妥、维生素B族、维生素C等药物存在配伍禁忌，不宜同瓶滴注
西索米星氯化钠	青霉素	药效降低，不良反应增加	西索米星氯化钠与β-内酰胺类(头孢菌素类或青霉素)混合可导致相互失活，需联合应用时必须分瓶注射
氯雷伪麻	对乙酰氨基酚	药效提高，不良反应增加	与氯霉素合用，氯雷伪麻所含对乙酰氨基酚可延长氯霉素的半衰期，增强其毒性；
布洛伪麻那敏混悬液	抗凝血	药效提高，不良反应增加	布洛伪麻那敏混悬液与肝素、双香豆素等抗凝血药合用时，可导致凝血酶原时间延长，增加出血倾向
达比加群	普拉格雷	不良反应增加	以下与达比加群联合使用时可能会增加出血风险的治疗缺乏经验或经验有限；抗凝药物如普通肝素（UFH）、低分子肝素（LMWH）、和肝素衍生物（磺达肝葵钠、地西卢定）、溶栓药物、维生素K拮抗剂、利伐沙班或其他口服抗凝药（参见【禁忌】），以及抗血小板聚集药物如GPIIb/IIIa受体拮抗剂、噻氯匹定、普拉格雷、替格瑞洛、右旋糖苷、磺吡酮（参见【注意事项】）
巴洛沙星	抗酸剂	药效提高，不良反应增加	含有金属铝、镁的抗酸剂会干扰喹诺酮类药物的吸收，故不能与巴洛沙星同时服用；2.与非甾体抗炎药同时使用可能干扰巴洛沙星的吸收，增加痉挛发作的危险性；3.喹诺酮类药物与茶碱类合用时可能使血清中的茶碱水平升高，因此巴洛沙星与茶碱合用时应降低茶碱的剂量
利福平Ⅱ	卡马西平	药效提高，不良反应增加	利福平Ⅱ可抑制卡马西平的代谢，使其血药浓度增高，引起毒性反应；卡马西平则可诱导异烟肼的微粒体代谢，使具有肝毒性的中间代谢物增加
利多卡因Ⅰ	磺胺嘧啶	药效降低，不良反应增加	与西咪替丁以及β受体阻断剂如，普萘洛尔、美托洛尔、纳多洛尔合用，利多卡因经肝脏代谢受抑制，利多卡因血浓度增加，可发生心脏和神经系统不良反应，应调整利多卡因剂量，并应心电图监护及监测利多卡因血药浓度；(2)巴比妥类药物可促进利多卡因代谢，两药合用可引起心动过缓，窦性停搏；(3)与普鲁卡因胺合用，可产生一过性谵妄及幻觉，但不影响利多卡因Ⅰ血药浓度；(4)异丙基肾上腺素因增加肝血流量，可使利多卡因Ⅰ的总清除率升高；去甲肾上腺素因减少肝血流量，可使利多卡因Ⅰ总清除率下降；(5)与下列药品有配伍禁忌：苯巴比妥，硫喷妥钠，硝普钠，甘露醇，两性霉素B，氨苄西林，磺胺嘧啶
小儿双嘧啶	磺胺嘧啶	药效提高，不良反应增加	与磺吡酮合用时可减少小儿双嘧啶中的磺胺嘧啶自肾小管的分泌，其血药浓度升高而持久，易产生毒性反应，因此在应用磺吡酮期间或应用其治疗后可能需要调整小儿双嘧啶的剂量
利托那韦口服溶液	阿咪唑	不良反应增加	阿普唑仑、安非他酮、胺碘酮、阿咪唑、苄替地尔、西沙必利、氯拉折帕、氯氮平、右丙氧芬、地西泮、二氢麦角胺、恩卡肢、舒乐安定、麦角胺、氟卡胺、氟西泮、咪达唑仑、哌替啶、匹莫齐特、吡罗昔康、普罗帕酮、奎尼丁、利福布丁、特非那定、三唑仑和左吡登禁止用于利托那韦口服溶液治疗的病人，因为它们可能与利托那韦口服溶液发生相互作用，产生严重并发症的危险
沙丁胺醇	肝素	药效提高，不良反应增加	沙丁胺醇与肝素、口服抗凝药合用时，使抗凝作用加强，因此有增加出血的危险
盐酸阿夫唑嗪缓释片	酮康唑	不良反应增加	因此，由于暴露量增加，盐酸阿夫唑嗪缓释片不能与强效CYP3A4抑制剂（如酮康唑、伊曲康唑或利托那韦）合用
利多卡因Ⅰ	磺胺嘧啶	药效提高，不良反应增加	与西咪替丁以及β受体阻断剂如，普萘洛尔、美托洛尔、纳多洛尔合用，利多卡因经肝脏代谢受抑制，利多卡因血浓度增加，可发生心脏和神经系统不良反应，应调整利多卡因剂量，并应心电图监护及监测利多卡因血药浓度；(2)巴比妥类药物可促进利多卡因代谢，两药合用可引起心动过缓，窦性停搏；(3)与普鲁卡因胺合用，可产生一过性谵妄及幻觉，但不影响利多卡因Ⅰ血药浓度；(4)异丙基肾上腺素因增加肝血流量，可使利多卡因Ⅰ的总清除率升高；去甲肾上腺素因减少肝血流量，可使利多卡因Ⅰ总清除率下降；(5)与下列药品有配伍禁忌：苯巴比妥，硫喷妥钠，硝普钠，甘露醇，两性霉素B，氨苄西林，磺胺嘧啶
普萘洛尔	对乙酰氨基酚	不良反应增加	长期应用对乙酰氨基酚患者应用普萘洛尔可增加肝脏中毒的危险性
伐地那非	坦洛新	不良反应增加	伐地那非5mg与坦洛新间隔6小时服用时，21位患者中有2位患者出现立位收缩压低于85mmHg
头孢孟多	复方乳酸钠注射液	药效降低，不良反应增加	头孢孟多制剂中含有碳酸钠，因而与含有钙或镁的溶液（包括复方氯化钠注射液或复方乳酸钠注射液）有配伍禁忌
阿莫西林克拉维酸钾	阿司匹林	药效提高，不良反应增加	阿司匹林、吲哚美辛、保泰松、磺胺药、丙磺舒可减少阿莫西林克拉维酸钾在肾小管的排泄，因而可使阿莫西林克拉维酸钾的血药浓度升高，而且维持较久，血消半衰期延长，毒性也可能增加
氨酚沙芬	氯霉素	不良反应增加	氨酚沙芬与氯霉素合用，可延长后者的半衰期，增强其毒性，应慎用
复方对乙酰氨基酚Ⅱ	颠茄	不良反应增加	应用巴比妥类（如苯比妥）或解痉药（如颠茄）的患者，长期使用复方对乙酰氨基酚Ⅱ时可至肝脏损害，故不应同服
头孢米诺	呋喃硫胺	不良反应增加	本口与氨茶碱、磷酸吡哆醛配伍会降低效价或着色，故不得配伍；与呋喃硫胺、硫辛酸，氢化可的松琥珀酸钠及腺苷钴胺配伍后时间稍长会变色，故配伍后应尽快使用；与利尿剂呋(呋喃苯胺酸等)等合用有可能增加肾毒性，应谨慎使用，动物实验证实，头孢米诺影响酒精代谢，使血中乙醛浓度上升，显示双硫仑样作用，故用药期间或用药后应禁酒
茶碱Ⅱ	林可霉素	药效提高，不良反应增加	与克林霉素、林可霉素及某些大环内酯类（红霉素、罗红霉素、克拉霉素）、喹诺酮类抗菌药（伊诺沙星、环丙沙星）合用时，可降低茶碱Ⅱ在肝脏的清除率，使血药浓度升高，甚至出现毒性反应，应在给药前后调整茶碱Ⅱ的用量
加压素	舒芬太尼	不良反应增加	应用含有静脉镇痛麻醉成分的药物(如异丙酚、舒芬太尼)可降低心率和输出量，同时使用加压素可能导致严重心动过缓
艾司唑仑	伊曲康唑	药效提高，不良反应增加	艾司唑仑与抗真菌药酮康唑、伊曲康唑合用，可提高艾司唑仑疗效并增加其毒性
奥硝唑	雷尼替丁	药效降低，不良反应增加	巴比妥类药物、雷尼替丁、西米替丁可加快奥硝唑的消除，降低其疗效并可凝血，当使用奥硝唑时应避免合用
阿莫西林	丙磺舒	不良反应增加	丙磺舒降低阿莫西林从肾小管中分泌，与阿莫西林合用时会升高阿莫西林的血药浓度，建议不与利尿酸药合用；别嘌呤醇(治痛风药)和阿莫西林合用会增加病人皮疹的发病率，尚未明确阿莫西林引发皮疹是由于因病人体内的别嘌呤醇还是因血尿酸升高引起的，尚未有阿莫西林与别嘌呤醇合用的资料；与其他广谱抗生素相似，阿莫西林可能降低避孕药的药效
巴氨西林	丙磺舒	药效提高，不良反应增加	丙磺舒、阿司匹林、吲哚美辛、保泰松、磺胺药可减少巴氨西林在肾小管的排泄，因而使巴氨西林的血药浓度升高，血消除半衰期（t1/2β）延长，毒性也可能增加
洛伐他汀	免疫抑制剂	不良反应增加	洛伐他汀与免疫抑制剂如环孢素、阿奇霉素、克拉霉素、红霉素、达那唑、伊曲康唑、吉非罗齐、烟酸等合用可增加肌溶解和急性肾功能衰竭发生的危险
阿莫西林克拉维酸钾	保泰松	药效提高，不良反应增加	阿司匹林、吲哚美辛、保泰松、磺胺药可减少阿莫西林克拉维酸钾在肾小管的排泄，因而使阿莫西林克拉维酸钾的血药浓度升高，血消除半衰期(t1/2β)延长，毒性也可能增加
复方布洛芬	甲氨蝶呤	药效提高，不良反应增加	复方布洛芬可降低甲氨蝶呤的排泄，增加其血药浓度，甚至可达中毒水平，故复方布洛芬不应与中或大剂量甲氨蝶呤同用
利多卡因	氨苄西林	药效提高，不良反应增加	与西咪替丁以及b受体阻断剂如，普萘洛尔、美托洛尔、纳多洛尔合用，利多卡因经肝脏代谢受抑制，利多卡因血浓度增加，可发生心脏和神经系统不良反应，应调整利多卡因剂量，并应心电图监护及监测利多卡因血药浓度；（2）巴比妥类药物可促进利多卡因代谢，两药合用可引起心动过缓，窦性停搏；（3）与普鲁卡因胺合用，可产生一过性谵妄及幻觉，但不影响利多卡因血药浓度；（4）异丙基肾上腺素因增加肝血流量，可使利多卡因的总清除率升高；去甲肾上腺素因减少肝血流量，可使利多卡因总清除率下降；（5）与下列药品有配伍禁忌：苯巴比妥，硫喷妥钠，硝普钠，甘露醇，两性霉素B，氨苄西林，磺胺嘧啶
头孢他啶	庆大霉素	药效降低，不良反应增加	头孢他啶与下列药物有配伍禁忌：硫酸阿米卡星、庆大霉素、卡那霉素
阿米替林	氟伏沙明	药效提高，不良反应增加	阿米替林与氟西汀或氟伏沙明合用，可增加两者的血浆浓度，出现惊厥，不良反应增加
氯胺酮	氟烷	不良反应增加	与氟烷等含卤全麻药同用时，氯胺酮的作用延长，苏醒迟延
茶碱Ⅱ	喹诺酮类	药效提高，不良反应增加	与克林霉素、林可霉素及某些大环内酯类（红霉素、罗红霉素、克拉霉素）、喹诺酮类抗菌药（依诺沙星、环丙沙星）合用时，可降低茶碱Ⅱ在肝脏的代谢，血药浓度升高，甚至出现毒性，应在给药前后调整茶碱Ⅱ的用量
双氯非那胺	奎尼丁	药效提高，不良反应增加	与苯丙胺、抗M-胆碱药、尤其是和阿托品、奎尼丁联合应用时，由于形成碱性尿，双氯非那胺排泄减少，会使不良反应加重或延长
苯唑西林	间羟胺	药效降低，不良反应增加	苯唑西林与氨基糖苷类、去甲肾上腺素、间羟胺、苯巴比妥、维生素B族、维生素C等药物存在配伍禁忌，不宜同瓶滴注
头孢克洛干糖浆	卡氮芥	不良反应增加	呋塞米、依他尼酸、布美他尼等强利尿药，卡氮芥、链佐星等抗肿瘤药及氨基糖苷类抗生素等肾毒性药物与头孢克洛干糖浆合用有增加肾毒性的可能
他莫昔芬	钙	药效提高，不良反应增加	骨转移的患者使用他莫昔芬治疗初期，那些能够降低肾脏钙排泄的药物，例如噻嗪利尿剂，可能增加高钙血症的风险（请参见“注意事项”）
氨酚伪麻	氯霉素	药效提高，不良反应增加	与氯霉素合用，氨酚伪麻所含对乙酰氨基酚可延长氯霉素的半衰期，增强其毒性；
环丙沙星	茶碱类	药效提高，不良反应增加	环丙沙星与茶碱类合用时可能由于与细胞色素P450结合部位的竞争性抑制，导致茶碱类的肝清除明显减少，血消除半衰期(T1/2β)延长，血药浓度升高，出现茶碱中毒症状，如恶心、呕吐、震颤、不安、激动、抽搐、心悸等，故合用时应测定茶碱类血药浓度和调整剂量
氯胺酮	甲状腺激素	不良反应增加	甲状腺激素、直接或间接作用的拟交感神经药和血管加压素与氯胺酮合用可能导致血压升高（高血压）和心率加速（心动过速）
丙泊酚	环孢菌素	不良反应增加	据报道，对接受环孢菌素治疗的患者给予脂肪乳剂如丙泊酚，可能导致白细胞脑炎
布洛芬咀嚼片	华法林	药效提高，不良反应增加	布洛芬咀嚼片与肝素、双香豆素（如华法林）等抗凝药同用时，可导致凝血酶原时间延长，增加出血倾向
克林霉素磷酸酯氯化钠注射液	麻醉药	不良反应增加	克林霉素磷酸酯氯化钠注射液可增强吸入性麻醉药的神经肌肉阻断现象，导致骨骼肌软弱和呼吸抑制或麻痹(呼吸暂停)，在手术中或术后同用时应注意，以抗胆碱酯酶药物或钙盐治疗可望有效
柔红霉素	肝素	不良反应增加	任何可能导致肝脏损害的药物如与柔红霉素同用，可增加阿霉素的肝毒性；与阿糖胞苷同用可导致坏死性结肠炎；与肝素、头孢菌素等混和应用易产生沉淀；
洛匹那韦/利托那韦口服溶液	右丙氧芬	不良反应增加	阿普唑仑、安非他酮、胺碘酮、阿咪唑、苄替地尔、西沙必利、氯拉折帕、氯氮平、右丙氧芬、地西泮、二氢麦角胺、恩卡肢、舒乐安定、麦角胺、氟卡胺、氟西泮、咪达唑仑、哌替啶、匹莫齐特、吡罗昔康、普罗帕酮、奎尼丁、利福布丁、特非那定、三唑仑和左吡登禁止用于洛匹那韦/利托那韦口服溶液治疗的病人，因为它们可能与洛匹那韦/利托那韦口服溶液发生相互作用，产生严重并发症的危险
利托那韦	氯拉折帕	不良反应增加	阿普唑仑、安非他酮、胺碘酮、阿咪唑、苄替地尔、西沙必利、氯拉折帕、氯氮平、右丙氧芬、地西泮、二氢麦角胺、恩卡肢、舒乐安定、麦角胺、氟卡胺、氟西泮、咪达唑仑、哌替啶、匹莫齐特、吡罗昔康、普罗帕酮、奎尼丁、利福布丁、特非那定、三唑仑和左吡登禁止用于利托那韦治疗的病人，因为它们可能与利托那韦发生相互作用，产生严重并发症的危险
利福平Ⅱ	抗肿瘤药	药效降低，不良反应增加	利福平Ⅱ可诱导肝微粒体酶，增加抗肿瘤药达卡巴嗪(dacarbazine)﹑环磷酰胺的代谢，形成烷化代谢物，促使白细胞减低，因此需调整剂量
西咪替丁	氟尿嘧啶	不良反应增加	西咪替丁可增强化疗药如：卡莫司汀、氟尿嘧啶、表柔比星或放射疗法的骨髓抑制作用（如：中性白细胞减少症，粒细胞缺乏症）
青霉素	阿莫西林	不良反应增加	虽然尚无青霉素与别嘌呤醇合用的资料，但阿莫西林与别嘌呤醇合用可能增加皮肤过敏反应
氯雷伪麻Ⅱ	氯霉素	药效提高，不良反应增加	与氯霉素合用，氯雷伪麻Ⅱ所含对乙酰氨基酚可延长氯霉素的半衰期，增强其毒性；
普萘洛尔	如胺碘酮	药效提高，不良反应增加	与CYP2D6酶底物或抑制剂，例如胺碘酮，西咪替丁，地拉韦啶，氟西汀，帕罗西汀，奎尼丁和利托那韦合用，可增加普萘洛尔的血浓度和/或毒性
对乙酰氨基酚	苯巴比妥	不良反应增加	应与巴比妥类（如苯巴比妥）或解痉药（如颠茄）的患者，长期应用对乙酰氨基酚可致肝损害
比索洛尔	去甲肾上腺素	药效提高，不良反应增加	同时激活β-和α-肾上腺受体的肾上腺素激动药（如去甲肾上腺素、肾上腺素）与比索洛尔合用可能加剧这些药物的α-肾上腺素受体介导的血管收缩作用，从而引起血压升高
艾司洛尔	血管收缩药	不良反应增加	此外，因为在全身血管阻力高时存在阻滞心脏收缩的危险，故在使用血管收缩药和影响肌肉收缩力的药物如多巴胺、肾上腺素和去甲肾上腺素时艾司洛尔不能用于控制室上性心动过速
西咪替丁	表柔比星	不良反应增加	西咪替丁可增强化疗药如：卡莫司汀、氟尿嘧啶、表柔比星或放射疗法的骨髓抑制作用（如：中性白细胞减少症，粒细胞缺乏症）
利多卡因Ⅱ	磺胺嘧啶	药效提高，不良反应增加	与西咪替丁以及β受体阻断剂如，普萘洛尔、美托洛尔、纳多洛尔合用，利多卡因经肝脏代谢受抑制，利多卡因血浓度增加，可发生心脏和神经系统不良反应，应调整利多卡因剂量，并应心电图监护及监测利多卡因血药浓度；(2)巴比妥类药物可促进利多卡因代谢，两药合用可引起心动过缓，窦性停搏；(3)与普鲁卡因胺合用，可产生一过性谵妄及幻觉，但不影响利多卡因Ⅱ血药浓度；(4)异丙基肾上腺素因增加肝血流量，可使利多卡因Ⅱ的总清除率升高；去甲肾上腺素因减少肝血流量，可使利多卡因Ⅱ总清除率下降；(5)与下列药品有配伍禁忌：苯巴比妥，硫喷妥钠，硝普钠，甘露醇，两性霉素B，氨苄西林，磺胺嘧啶
噻吗洛尔	奎宁	不良反应增加	噻吗洛尔与奎宁丁合用能引起心率减慢等全身β-受体阻断的副作用
阿托品	三环类抗抑郁药	不良反应增加	与金刚烷胺、吩噻嗪类药、其他抗胆碱药、扑米酮、普鲁卡因胺、三环类抗抑郁药伍用，阿托品的毒副反应可加剧
维生素K1	苯妥英钠	药效降低，不良反应增加	维生素K1与苯妥英钠混合2小时后可出现颗粒沉淀，与维生素C、维生素B12、右旋糖酐混合易出现混浊
醋酸戈舍瑞林缓释植入剂	多非利特	不良反应增加	由于雄激素剥夺治疗可能延长QT间期，当醋酸戈舍瑞林缓释植入剂与已知可延长QT间期药物或可能会诱导尖端扭转型室性心动过速的药物如ⅠA类（如奎尼丁、丙吡胺）或Ⅲ类抗心律失常药物（如胺碘酮、索他洛尔、多非利特、伊布利特）、美沙酮、莫西沙星、抗精神病药物等合用时，应谨慎评估（详见【注意事项】）
氯化钠	克林霉素	药效提高，不良反应增加	与克林霉素、林可霉素及某些大环内酯类（红霉素、罗红霉素、克拉霉素）、喹诺酮类抗菌药（伊诺沙星、环丙沙星）合用时，可降低氯化钠在肝脏的清除率，使血药浓度升高，甚至出现毒性反应，应在给药前后调整氯化钠的用量
维生素C	口服降糖药	药效提高，不良反应增加	维生素C可加强口服降糖药及甲氨蝶呤的作用，不应同用
布洛伪麻那敏混悬液	双香豆素	药效提高，不良反应增加	布洛伪麻那敏混悬液与肝素、双香豆素等抗凝血药合用时，可导致凝血酶原时间延长，增加出血倾向
利福喷丁	环磷酰胺	药效降低，不良反应增加	利福喷丁可诱导肝微粒体酶，增加抗肿瘤药达卡巴嗪(dacarbazine)、环磷酰胺的代谢，形成烷化代谢物，促使白细胞减低，因此需调整剂量
复方头孢克洛干混悬剂	强利尿药	不良反应增加	呋塞米、依他尼酸、布美他尼等强利尿药，卡氮芥、链佐星等抗肿瘤药及氨基糖苷类抗生素等肾毒性药物与复方头孢克洛干混悬剂合用有增加肾毒性的可能
利多卡因	美托洛尔	药效提高，不良反应增加	与西米替丁以及与β受体阻断剂如：普萘洛尔、美托洛尔、纳多洛尔合用，利多卡因经肝脏代谢受抑制，利多卡因血浓度增加，可发生心脏和神经系统不良反应，应调整利多卡因剂量，并应心电图监护及监测利多卡因血药浓度
甲氨蝶呤	叶酸	不良反应增加	氨苯喋啶，乙胺嘧啶等药物均有抗叶酸作用，如与甲氨蝶呤同用可增加其毒副作用；
氨苄西林	丙磺舒	药效提高，不良反应增加	丙磺舒、阿司匹林、吲哚美辛、保泰松、磺胺药可减少氨苄西林自肾脏排泄，因此与氨苄西林合用时使其血药浓度增高，排泄时间延长，毒性也可能增加
颠茄片	金刚烷胺	不良反应增加	颠茄片与金刚烷胺、美克洛嗪、吩噻嗪类药（氯丙嗪、奋乃静）、阿托品类药、普鲁卡因胺、三环类抗抑郁药等同用时，颠茄片的不良反应可加剧
注射用酒石酸美托洛尔	利血平	不良反应增加	儿茶酚胺耗竭剂(如利血平)与注射用酒石酸美托洛尔合用时会引起晕眩，或体位性低血压
酮洛芬片	肝素	药效提高，不良反应增加	酮洛芬片与肝素、双香豆素等抗凝药同时使用，可导致凝血酶原时间延长，增加出血倾向
依诺沙星	非甾体类抗炎药	不良反应增加	依诺沙星与非甾体类抗炎药芬布芬合用时，偶有抽搐发生，因此不宜与芬布芬合用
茶碱Ⅱ	喹诺酮类	药效提高，不良反应增加	与克林霉素、林可霉素及某些大环内酯类(红霉素、罗红霉素、克拉霉素)、喹诺酮类抗菌药(伊诺沙星、环丙沙星)合用时，可降低茶碱Ⅱ在肝脏的清除率，使血药浓度升高，甚至出现毒性反应，应在给药时调整茶碱Ⅱ的用量
克拉维酸钾	吲哚美辛	药效提高，不良反应增加	．阿司匹林、吲哚美辛、保泰松、磺胺药可减少克拉维酸钾在肾小管的排泄，因而使克拉维酸钾的血药浓度升高，血消除半衰期（t1/2β）延长，毒性也可能增加
羧苄西林	卡那霉素	药效降低，不良反应增加	羧苄西林与琥珀氯霉素、琥乙红霉素、盐酸土霉素、盐酸四环素、卡那霉素、链霉素、庆大霉素、妥布霉素、两性霉素B、维生素B族、维生素C、苯妥英钠、拟交感类药物、异丙嗪等有配伍禁忌
西索米星	呋喃妥因	药效降低，不良反应增加	西索米星不宜与两性霉素B、头孢噻吩钠、呋喃妥因钠、磺胺嘧啶钠和四环素等（以上均为注射液）联合应用，因可发生配伍禁忌
奎宁	曲美苄胺	不良反应增加	酸药及含铝制剂能延缓或减少奎宁的吸收；②抗凝药与奎宁合用后，抗凝作用可增强；③肌肉松弛药如琥珀胆碱、筒箭毒碱等与奎宁合同，可能会引起呼吸抑制；④奎尼丁与奎宁合用，金鸡纳反应可增加；⑤尿液碱化剂如碳酸氢钠等，可增加肾小管对奎宁的重吸收，导致奎宁血药浓度与毒性的增加；⑥与维生素K合用可增加奎宁的吸收；⑦与布克利嗪、赛克利嗪、美克利嗪、吩噻嗪类、噻吨类、曲美苄胺（trimethofenzamide）、氨基苷类抗生素合用可导致耳鸣、眩晕；⑧与硝苯地平（硝苯啶）合用，游离的奎宁浓度增加
甘氨酸茶碱钠胶囊	地尔硫卓	药效提高，不良反应增加	地尔硫卓、维拉帕米可干扰茶碱在肝内的代谢，与甘氨酸茶碱钠胶囊合用，增加甘氨酸茶碱钠胶囊血药浓度和毒性
普萘洛尔	保泰松	药效提高，不良反应增加	与抗凝剂如香豆素类或氯霉素、异烟肼、保泰松、磺胺类合用，可减低普萘洛尔的代谢，可能增加普萘洛尔的毒性
普萘洛尔	抗凝剂	药效提高，不良反应增加	与抗凝剂如香豆素类或氯霉素、异烟肼、保泰松、磺胺类合用，可减低普萘洛尔的代谢，可能增加普萘洛尔的毒性
异福酰胺	达卡巴嗪	药效降低，不良反应增加	异福酰胺可诱导肝微粒体酶，增加抗肿瘤药达卡巴嗪(dacarbazine)、环磷酰胺的代谢，形成烷化代谢物，促使白细胞减低，因此需调整剂量
利托那韦口服溶液	恩卡肢	不良反应增加	阿普唑仑、安非他酮、胺碘酮、阿咪唑、苄替地尔、西沙必利、氯拉折帕、氯氮平、右丙氧芬、地西泮、二氢麦角胺、恩卡肢、舒乐安定、麦角胺、氟卡胺、氟西泮、咪达唑仑、哌替啶、匹莫齐特、吡罗昔康、普罗帕酮、奎尼丁、利福布丁、特非那定、三唑仑和左吡登禁止用于利托那韦口服溶液治疗的病人，因为它们可能与利托那韦口服溶液发生相互作用，产生严重并发症的危险
利多卡因	西咪替丁	药效提高，不良反应增加	与西咪替丁以及与受体阻滞剂如，普萘洛尔、美托洛尔、纳多洛尔合用，利多卡因经肝脏代谢受抑制，利多卡因血浓度增加，可发生心脏和神经系统不良反应
复方氨酚愈敏	奎尼丁	不良反应增加	奎尼丁和复方氨酚愈敏合用，其阿托品样效应加剧
阿莫西林	阿司匹林	药效提高，不良反应增加	阿司匹林、吲哚美辛、保泰松、磺胺药可减少阿莫西林在肾小管的排泄，因而使阿莫西林的血药浓度升高，血消除半衰期(t1/2β)延长，毒性也可能增加
托特罗定	红霉素	药效提高，不良反应增加	不建议与强CYP3A4抑制剂，如大环内酯抗生素（如，红霉素和克拉霉素），抗真菌药（如，酮康唑，咪康唑和伊曲康唑）和抗蛋白酶合并全身给药，因为托特罗定在CYP2D6弱代谢者中的血清浓度会升高，（之后）出现过量的风险（见药物过量）
氯贝酸铝	辛伐他汀	不良反应增加	氯贝酸铝有可能引起肌病或横纹肌溶解，因此应尽量避免与HMG-CoA还原酶抑制剂，如普伐他汀、辛伐他汀等合用，以减少两者严重肌肉毒性发生的危险
达比加群	卡马西平	药效提高，不良反应增加	预计与P-gp诱导物（如：利福平、贯叶连翘（金丝桃）、卡马西平、或苯妥英等）联合使用会降低达比加群血药浓度，因此应该避免联合使用（参见【注意事项】和【药代动力学】）
对乙酰氨基酚	苯巴比妥	不良反应增加	应用巴比妥（如苯巴比妥）或解痉药（如颠茄）的患者，长期应用对乙酰氨基酚可致肝损害
阿托伐他汀	吉非罗齐	不良反应增加	HMG-CoA还原酶抑制剂与吉非罗齐进行联合应用时，造成肌病/横纹肌溶解发生的风险增高，因此阿托伐他汀与吉非罗齐应避免联合应用（见【注意事项】）
麻黄碱	缩宫素	药效提高，不良反应增加	麻黄碱与麦角新碱，麦角胺或缩宫素合用，可加剧血管收缩，导致严重高血压或外周组织缺血
罗替高汀	多巴胺受体激动剂	不良反应增加	与其他多巴胺受体激动剂一样，罗替高汀可能加重左旋多巴的多巴胺能不良反应，并可能引发和/或加重已知运动障碍
罗红霉素	特非那定	药效提高，不良反应增加	特非那定和阿司咪唑：罗红霉素可导致特非那定和阿司咪唑血药浓度升高，引发严重的室性心律失常
茚地那韦	利托那韦	药效提高，不良反应增加	茚地那韦与咪唑安定合用时，无论是否再与利托那韦合用均有可能导致咪唑安定浓度的明显升高
依托红霉素	华法林	药效提高，不良反应增加	4.长期服用华法林的患者应用依托红霉素时可导致凝血酶原时间延长，从而增加出血的危险性，老年病人尤应注意
酮洛芬片	抗凝药	药效提高，不良反应增加	酮洛芬片与肝素、双香豆素等抗凝药同时使用，可导致凝血酶原时间延长，增加出血倾向
氯化钠	茶碱类	药效提高，不良反应增加	氯化钠与茶碱类合用时可能由于与细胞色素P450结合部位的竞争性抑制，导致茶碱类的肝清除明显减少，血消除半衰期延长，血药浓度升高，出现茶碱中毒症状，如恶心、呕吐、震颤、不安、激动、抽搐、心悸等，故合用时应测定茶碱类的血药浓度和调整剂量
酮洛芬	甲氨蝶呤	药效提高，不良反应增加	酮洛芬可降低甲氨蝶呤的排泄，增高其血药浓度，甚至可达中毒水平，故酮洛芬不应与中或大剂量甲氨蝶呤疗法同用
二盐酸珠氯噻醇片	哌嗪	不良反应增加	同时服用驱虫药哌嗪，可增加二盐酸珠氯噻醇片的锥体外系反应的发生率
阿咖酚	酒精	不良反应增加	阿咖酚不应与含有酒精的饮料、巴比妥类(如苯巴比妥)、解痉药类(如颠茄)同服，因可造成肝损害
舒巴坦	利多卡因	药效降低，不良反应增加	由于舒巴坦与2％盐酸利多卡因注射液混合后有配伍禁忌，因此应避免在最初溶解时使用此溶液
利多卡因	美托洛尔	药效提高，不良反应增加	与西咪替丁以及b受体阻断剂如，普萘洛尔、美托洛尔、纳多洛尔合用，利多卡因经肝脏代谢受抑制，利多卡因血浓度增加，可发生心脏和神经系统不良反应，应调整利多卡因剂量，并应心电图监护及监测利多卡因血药浓度；（2）巴比妥类药物可促进利多卡因代谢，两药合用可引起心动过缓，窦性停搏；（3）与普鲁卡因胺合用，可产生一过性谵妄及幻觉，但不影响利多卡因血药浓度；（4）异丙基肾上腺素因增加肝血流量，可使利多卡因的总清除率升高；去甲肾上腺素因减少肝血流量，可使利多卡因总清除率下降；（5）与下列药品有配伍禁忌：苯巴比妥，硫喷妥钠，硝普钠，甘露醇，两性霉素B，氨苄西林，磺胺嘧啶
肝素	柔红霉素	药效降低，不良反应增加	下列药物与肝素有配伍禁忌：卡那霉素、阿米卡星、柔红霉素、乳糖酸红霉素、硫酸庆大霉素、氢化考的松琥珀酸钠、多粘菌素B、阿霉素、妥布霉素、万古霉素、头孢孟多、头孢氧哌唑、头孢噻吩钠、氯喹丙嗪、异丙嗪、麻醉性镇痛药
盐酸奥布卡因滴眼液	血管收缩药	不良反应增加	高血压、动脉硬化、心功能不全、甲状腺机能亢进、糖尿病、血管痉挛等病的患者使用盐酸奥布卡因滴眼液时同用血管收缩药如肾上腺素、去甲肾上腺素等，可能会引起上述症状的加剧，应禁用
布洛芬	抗凝药	药效提高，不良反应增加	布洛芬与肝素、双香豆索等抗凝药同用时，可导致凝血酶原时间延长，增加出血倾向
单硝酸异山梨酯Ⅲ	西地那非	药效提高，不良反应增加	和西地那非合用会加强单硝酸异山梨酯Ⅲ的降压作用（见禁忌），这将导致危及生命的心血管并发症，所以正在接受单硝酸异山梨酯Ⅲ治疗的病人不可使用西地那非
硫磺苯甲酸苄酯乳膏	酒精	不良反应增加	硫磺苯甲酸苄酯乳膏与清洁剂、含有酒精的制剂、维A酸等共用，可过度刺激皮肤或使皮肤更加干燥
辛伐他汀	细胞色素P4503A4	不良反应增加	当辛伐他汀与其他在治疗剂量下对细胞色素P4503A4有明显抑制作用的药物(如：环孢霉素、米贝地尔、伊曲康唑、酮康唑、红霉素、克拉霉素和奈法唑酮)或纤维酸类衍生物或烟酸合用时，导致横纹肌溶解的危险性增高
右旋酮洛芬氨丁三醇	丙磺舒	药效提高，不良反应增加	右旋酮洛芬氨丁三醇不应与丙磺舒同用，因后者可明显降低右旋酮洛芬氨丁三醇肾脏清除率(降低66%)和蛋白结合率(降低28%)，导致血药浓度增高，而有引起中毒的危险
环丙沙星	茶碱类	药效提高，不良反应增加	环丙沙星与茶碱类合用时可能由于与细胞色素P450结合部位的竞争性抑制，导致茶碱类的肝清除明显减少，血清除半衰期（t1/2β）延长，血药浓度升高，出现茶碱中毒症状，如恶心、呕吐、震颤、不安、激动、抽搐、心悸等，故合用时应测定茶碱类血药浓度和调整剂量
辛伐他汀	伊曲康唑	不良反应增加	当辛伐他汀与其他在治疗剂量下对细胞色素P4503A4有明显抑制作用的药物（如：环孢霉素、米贝地尔、伊曲康唑、酮康唑、红霉素、克拉霉素和奈法唑酮）或纤维酸类衍生物或烟酸合用时，导致横纹肌溶解的危险性增高
复方双嗪利血平	洋地黄类	不良反应增加	与其他降压药同用时剂量需调整；2.与洋地黄类或奎尼丁同用，大剂量使用可引起心律失常；3.与三环类抗抑郁药合用，可减弱复方双嗪利血平的降压作用
氯普噻吨	肾上腺素	药效降低，不良反应增加	氯普噻吨与肾上腺素合用，由于a受体活动受阻，b受体活动占优势，可出现血压下降
林可霉素	阿片	不良反应增加	与阿片类镇痛药合用，林可霉素的呼吸抑制作用与阿片类的中枢呼吸抑制作用可因累加现象而有导致呼吸抑制延长或引起呼吸麻痹（呼吸暂停）的可能，故必须对病人进行密切观察或监护
雷米普利	降糖药	药效提高，不良反应增加	－口服抗糖药（如磺脲类、双胍类）、胰岛素：由于潜在地降低胰岛素抵抗，雷米普利可增强降糖药效果，具产生低血糖的风险（尤其在治疗初期，应仔细监测血糖水平）
利多卡因Ⅱ	硫喷妥钠	不良反应增加	与西咪替丁以及β受体阻断剂如，普萘洛尔、美托洛尔、纳多洛尔合用，利多卡因经肝脏代谢受抑制，利多卡因血浓度增加，可发生心脏和神经系统不良反应，应调整利多卡因剂量，并应心电图监护及监测利多卡因血药浓度；(2)巴比妥类药物可促进利多卡因代谢，两药合用可引起心动过缓，窦性停搏；(3)与普鲁卡因胺合用，可产生一过性谵妄及幻觉，但不影响利多卡因Ⅱ血药浓度；(4)异丙基肾上腺素因增加肝血流量，可使利多卡因Ⅱ的总清除率升高；去甲肾上腺素因减少肝血流量，可使利多卡因Ⅱ总清除率下降；(5)与下列药品有配伍禁忌：苯巴比妥，硫喷妥钠，硝普钠，甘露醇，两性霉素B，氨苄西林，磺胺嘧啶
缬沙坦氨氯地平片(Ⅰ)	锂	不良反应增加	如果同时使用利尿剂，锂中毒的风险可能会随着缬沙坦氨氯地平片(Ⅰ)的使用进一步增加
复方庆大霉素	普鲁卡因胺	药效提高，不良反应增加	复方庆大霉素有普鲁卡因胺合用，可减少后者肾清除，致使普鲁卡因胺代谢物NAPA的血浓度增高
茶碱Ⅱ	罗红霉素	药效提高，不良反应增加	与克林霉素、林可霉素及某些大环内酯类（红霉素、罗红霉素、克拉霉素）、喹诺酮类抗菌药（伊诺沙星、环丙沙星）合用时，可降低茶碱Ⅱ在肝脏的清除率，使血药浓度升高，甚至出现毒性反应，应在给药前后调整茶碱Ⅱ的用量
麻黄碱	麦角新碱	药效提高，不良反应增加	麻黄碱与麦角新碱、麦角胺或缩宫素合用，可加剧血管收缩，导致严重高血压或外周组织缺血
布洛芬	肝素	药效提高，不良反应增加	布洛芬与肝素、双香豆索等抗凝药同用时，可导致凝血酶原时间延长，增加出血倾向
米力农	速尿	药效降低，不良反应增加	化学上的相互作用：当速尿加入含有米力农的注射液中，会迅速发生化学反应而出现沉淀
注射用福莫司汀	达卡巴嗪	不良反应增加	当注射用福莫司汀与大剂量达卡巴嗪在同一天同时应用时偶尔会发生肺毒性（急性成年人呼吸窘迫综合症），注意避免此种给药方法
二甲双胍格列本脲胶囊	苯妥英钠	不良反应增加	噻嗪类和其他利尿药、皮质醇类、酚噻嗪类、甲状腺制剂、性激素类、口服避孕药、苯妥英钠、烟酸、拟交感神经药、钙离子通道阻滞剂，异烟肼可产生难以控制的高血糖，当病人同服二甲双胍格列本脲胶囊和上述药物时，应注意观察病人血糖水平的变化
注射用糜蛋白酶	乙酰唑胺	不良反应增加	对注射用糜蛋白酶引起的青光眼症状，于术后滴入β受体阻滞药（如噻吗洛乐），或口服碳酸酶抵制剂（如乙酰唑胺），可望得到减轻
注射用头孢地嗪钠	环孢素	不良反应增加	注射用头孢地嗪钠可加强具有潜在肾毒性药物的毒性作用，如与氨基糖苷类、两性霉素B、环孢素、顺铂、万古霉素、多粘菌素B或粘菌素同时或先后使用时，应密切监测肾功能
复方氨酚愈敏口服溶液	奎尼丁	不良反应增加	奎尼丁和复方氨酚愈敏口服溶液合用，其阿托品样效应加剧
地巴唑	间羟胺	药效降低，不良反应增加	与拟交感类药同用使地巴唑的降压作用减弱，也可使拟交感类药的升压作用增强，间羟胺与地巴唑同用可至高血压危象
利福平	抗肿瘤药	药效降低，不良反应增加	利福平可诱导肝微粒体酶，增加抗肿瘤药达卡巴嗪(dacarbazine)、环磷酰胺的代谢、烷化代谢物的形成，促使白细胞减低，因此需调整剂量
头孢他啶	硫酸阿米卡星	药效降低，不良反应增加	头孢他啶与下列药物有配伍禁忌：硫酸阿米卡星、庆大霉素、卡那霉素
酮康唑	卤泛群	不良反应增加	-由于酮康唑与CYP3A4底物合用会增加这些药物的血浆浓度，而可能导致QT间期延长和个别出现尖端扭转型室速，因此酮康唑禁止与下列药物合用：特非那丁、苄普地尔、阿司咪唑、卤泛群、左醋美沙朵(左美沙酮)、咪唑斯汀、西沙必利、多非利特、奎尼丁、匹莫齐特、苯丙胺、舍吲哚；
洛匹那韦/利托那韦口服溶液	恩卡肢	不良反应增加	阿普唑仑、安非他酮、胺碘酮、阿咪唑、苄替地尔、西沙必利、氯拉折帕、氯氮平、右丙氧芬、地西泮、二氢麦角胺、恩卡肢、舒乐安定、麦角胺、氟卡胺、氟西泮、咪达唑仑、哌替啶、匹莫齐特、吡罗昔康、普罗帕酮、奎尼丁、利福布丁、特非那定、三唑仑和左吡登禁止用于洛匹那韦/利托那韦口服溶液治疗的病人，因为它们可能与洛匹那韦/利托那韦口服溶液发生相互作用，产生严重并发症的危险
复方对乙酰氨基酚Ⅱ	巴比妥类	不良反应增加	复方对乙酰氨基酚Ⅱ不应与含有酒精的饮料、巴比妥类(如苯巴比妥)、解痉药类(如颠茄)同服，因可造成肝损害
辛伐他汀	烟酸	不良反应增加	吉非贝齐和其它贝特类药物，降脂剂量（≥1g/天）的烟酸（尼克酸）：这些药物与辛伐他汀合用时发生肌病的危险性增加，可能是因为这些药物单独使用时均能引起肌病发生（请参阅【注意事项】，1.肌肉作用）
安非他酮	左旋多巴	不良反应增加	左旋多巴：临床资料表明同时使用安非他酮和左旋多巴后，不良反应发生率可能升高
肌苷氯化钠注射液	盐酸普鲁卡因	药效降低，不良反应增加	肌苷氯化钠注射液禁与下列注射液配伍：乳清酸、氯霉素、双嘧达莫、盐酸山梗菜碱、硫酸阿托品、氢溴酸东莨菪碱、盐酸氯丙嗪、盐酸异丙嗪、马来酸麦角新碱、盐酸普鲁卡因、硫喷妥钠、苯妥英钠、氯氮卓、盐酸去甲肾上腺素、盐酸丁卡因、利血平、硝普钠、降压嗪、呋噻米、利尿酸钠、促皮质素、维生素B12、盐酸苯海拉明、马来酸氯苯那敏、细胞色素C、盐酸万古霉素、盐酸四环素、二盐酸奎宁、盐酸阿糖胞苷、硫酸长春新碱以及所有菌苗和疫苗
洛匹那韦/利托那韦口服溶液	阿普唑仑	不良反应增加	阿普唑仑、安非他酮、胺碘酮、阿咪唑、苄替地尔、西沙必利、氯拉折帕、氯氮平、右丙氧芬、地西泮、二氢麦角胺、恩卡肢、舒乐安定、麦角胺、氟卡胺、氟西泮、咪达唑仑、哌替啶、匹莫齐特、吡罗昔康、普罗帕酮、奎尼丁、利福布丁、特非那定、三唑仑和左吡登禁止用于洛匹那韦/利托那韦口服溶液治疗的病人，因为它们可能与洛匹那韦/利托那韦口服溶液发生相互作用，产生严重并发症的危险
氯喹	甲氟喹	不良反应增加	羟氯喹与其它已知可降低惊厥阈值的抗疟疾药（例如，甲氟喹）合用可能增加惊厥的风险
对乙酰氨基酚	颠茄	不良反应增加	对乙酰氨基酚不应与含有酒精的饮料、巴比妥类（如苯巴比妥）、解痉药（如颠茄）同服，因可造成肝脏损害
瑞舒伐他汀	华法林	不良反应增加	维生素K拮抗剂：同其它HMG－CoA还原酶抑制剂一样，对同时使用维生素K拮抗剂(如：华法林或其他香豆素类抗凝剂)的患者，开始使用瑞舒伐他汀或逐渐增加瑞舒伐他汀剂量可能导致国际标准化比率(INR)升高
氯喹	胺碘酮	不良反应增加	另外，羟氯喹与其他致心律失常药（例如，胺碘酮和莫西沙星）合用可能增加诱导室性心律失常的风险
托拉塞米	庆大霉素	不良反应增加	可加强氨基糖甙类抗生素（如卡那霉素、庆大霉素、妥布霉素）、抑制细胞增殖的铂衍生物和头孢菌素的耳毒性和肾脏毒性效应，特别是大剂量托拉塞米治疗时；
头孢米诺	硫辛酸	药效降低，不良反应增加	本口与氨茶碱、磷酸吡哆醛配伍会降低效价或着色，故不得配伍；与呋喃硫胺、硫辛酸，氢化可的松琥珀酸钠及腺苷钴胺配伍后时间稍长会变色，故配伍后应尽快使用；与利尿剂呋(呋喃苯胺酸等)等合用有可能增加肾毒性，应谨慎使用，动物实验证实，头孢米诺影响酒精代谢，使血中乙醛浓度上升，显示双硫仑样作用，故用药期间或用药后应禁酒
洛匹那韦/利托那韦口服溶液	氟西泮	不良反应增加	阿普唑仑、安非他酮、胺碘酮、阿咪唑、苄替地尔、西沙必利、氯拉折帕、氯氮平、右丙氧芬、地西泮、二氢麦角胺、恩卡肢、舒乐安定、麦角胺、氟卡胺、氟西泮、咪达唑仑、哌替啶、匹莫齐特、吡罗昔康、普罗帕酮、奎尼丁、利福布丁、特非那定、三唑仑和左吡登禁止用于洛匹那韦/利托那韦口服溶液治疗的病人，因为它们可能与洛匹那韦/利托那韦口服溶液发生相互作用，产生严重并发症的危险
氢氯噻嗪	噻嗪类利尿剂	不良反应增加	金刚烷胺：与噻嗪类利尿剂（包括氢氯噻嗪）同时使用可能增加金刚烷胺发生不良反应的风险
氨苄西林	别嘌醇	不良反应增加	与别嘌醇合用可使氨苄西林皮疹发生率增加，尤其多见于高尿酸血症
利托那韦	匹莫齐特	不良反应增加	阿普唑仑、安非他酮、胺碘酮、阿咪唑、苄替地尔、西沙必利、氯拉折帕、氯氮平、右丙氧芬、地西泮、二氢麦角胺、恩卡肢、舒乐安定、麦角胺、氟卡胺、氟西泮、咪达唑仑、哌替啶、匹莫齐特、吡罗昔康、普罗帕酮、奎尼丁、利福布丁、特非那定、三唑仑和左吡登禁止用于利托那韦治疗的病人，因为它们可能与利托那韦发生相互作用，产生严重并发症的危险
对乙酰氨基酚	酒精	不良反应增加	|2.酒精可增加对乙酰氨基酚过量引起的肝毒性
左奥硝唑	阿洛西林	药效降低，不良反应增加	文献报道，奥硝唑与呋布西林钠、萘夫西林钠、奥美拉唑、沃必唑、注射用炎琥宁、阿洛西林钠存在配伍禁忌，左奥硝唑在使用时也应注意
对乙酰氨基酚	苯巴比妥	不良反应增加	对乙酰氨基酚不应与含有酒精的饮料、巴比妥类（如苯巴比妥）、解痉药（如颠茄）同服，因可造成肝脏损害
利福平	环磷酰胺	药效降低，不良反应增加	利福平可诱导肝微粒体酶，增加抗肿瘤药达卡巴嗪(dacarbazine)﹑环磷酰胺的代谢，形成烷化代谢物，促使白细胞减低，因此需调整剂量
利托那韦	胺碘酮	不良反应增加	阿普唑仑、安非他酮、胺碘酮、阿咪唑、苄替地尔、西沙必利、氯拉折帕、氯氮平、右丙氧芬、地西泮、二氢麦角胺、恩卡肢、舒乐安定、麦角胺、氟卡胺、氟西泮、咪达唑仑、哌替啶、匹莫齐特、吡罗昔康、普罗帕酮、奎尼丁、利福布丁、特非那定、三唑仑和左吡登禁止用于利托那韦治疗的病人，因为它们可能与利托那韦发生相互作用，产生严重并发症的危险
阿扎司琼	吡咯他尼	药效降低，不良反应增加	阿扎司琼与碱性注射液(如呋喃苯胺酸、甲氯蝶呤、氟尿嘧啶，吡咯他尼等注射液)或鬼臼乙叉甙注射液配伍会发生浑浊或结晶析出，故需将阿扎司琼先用氯化钠注射液稀释后，方可与上述碱性药物配伍使用
异烟肼	对乙酰氨基酚	不良反应增加	与对乙酰氨基酚合用时，由于异烟肼可诱导肝细胞色素P-450，使前者形成毒性代谢物的量增加，可增加肝毒性及肾毒性
醋酸戈舍瑞林缓释植入剂	美沙酮	不良反应增加	由于雄激素剥夺治疗可能延长QT间期，当醋酸戈舍瑞林缓释植入剂与已知可延长QT间期药物或可能会诱导尖端扭转型室性心动过速的药物如ⅠA类（如奎尼丁、丙吡胺）或Ⅲ类抗心律失常药物（如胺碘酮、索他洛尔、多非利特、伊布利特）、美沙酮、莫西沙星、抗精神病药物等合用时，应谨慎评估（详见【注意事项】）
氯化钠	磺胺嘧啶	药效降低，不良反应增加	氯化钠不宜与两性霉素B、头孢噻吩、呋喃妥英钠、磺胺嘧啶钠和四环素等(以上均为注射液)联合应用，因可发生配伍禁忌
酮康唑	阿司咪唑	不良反应增加	酮康唑与西沙必利、阿司咪唑、特非那定合用属禁忌，因合用时抑制细胞色素P-450代谢通道，可导致心律紊乱
克拉霉素	奎尼丁	不良反应增加	有上市后报道，当克拉霉素和奎尼丁或丙毗胺合用时有扭转峰值现象发生
酚咖	苯巴比妥	不良反应增加	酚咖不应与含有酒精的饮料、巴比妥类(如苯巴比妥)、解痉药类(如颠茄)同服，因可造成肝损害
复方双嗪利血平	降压药	不良反应增加	与其他降压药同用时剂量需调整；2.与洋地黄类或奎尼丁同用，大剂量使用可引起心律失常；3.与三环类抗抑郁药合用，可减弱复方双嗪利血平的降压作用
雷米普利	非甾体抗炎药	药效降低，不良反应增加	非甾体抗炎药物、止痛剂(如消炎痛、乙酰水杨酸)：可能减弱雷米普利的降压效果，还可能增加肾功能损害和血清钾浓度升高的危险
氯唑西林	苯巴比妥	药效降低，不良反应增加	氯唑西林与氨基糖苷类、去甲肾上腺素、间羟胺、苯巴比妥、维生素B族、维生素C等药物存在配伍禁忌，不宜同瓶滴注
小儿氨咖黄敏	颠茄	不良反应增加	l.应用巴比妥类(如苯巴比妥)或解痉药(如颠茄)的患者，长期使用小儿氨咖黄敏时可致肝脏损害
卡马西平	异烟肼	不良反应增加	据报道，卡马西平与异烟肼联合使用可增加异烟肼诱导的肝脏毒性的发生率
文拉法辛	SSRIs	不良反应增加	类似其它5-羟色胺能药物，使用文拉法辛治疗时，可能发生5-羟色胺综合征（一种有潜在生命威胁的情况），尤其是在与以下药物合并使用时：其它作用于5-羟色胺递质系统的药物（包括曲坦、SSRIs、其它SNRIs、锂盐、西布曲明、曲马多或圣约翰草[金丝桃属植物提取物]），损害5-羟色胺代谢的药物（如MAOIs，包括利奈唑胺[一种抗生素，是可逆性、非选择性的MAOI]和亚甲蓝）或5-羟色胺前体（如：色氨酸补充剂）（见[禁忌]和[注意事项]）
利托那韦	利福布丁	不良反应增加	阿普唑仑、安非他酮、胺碘酮、阿咪唑、苄替地尔、西沙必利、氯拉折帕、氯氮平、右丙氧芬、地西泮、二氢麦角胺、恩卡肢、舒乐安定、麦角胺、氟卡胺、氟西泮、咪达唑仑、哌替啶、匹莫齐特、吡罗昔康、普罗帕酮、奎尼丁、利福布丁、特非那定、三唑仑和左吡登禁止用于利托那韦治疗的病人，因为它们可能与利托那韦发生相互作用，产生严重并发症的危险
伊布利特	如胺碘酮	不良反应增加	抗心律失常药：Ia类抗心律失常药(VauZhanWilliams分类法)，如丙吡胺、奎尼丁、普鲁卡因胺以及其它的Ⅲ类药物，如胺碘酮、索他洛尔因可能延长不应期，均不能和伊布利特注射液同时使用或注射后4小时内使用
氧	氨基糖苷类	药效降低，不良反应增加	氧与氨基糖苷类、去甲肾上腺素、间羟胺、苯巴比妥、维生素B族、维生素C等药物存在配伍禁忌，不宜同瓶滴注
索他洛尔	丙吡胺	不良反应增加	Ⅰa类抗心律失常药如丙吡胺、奎尼丁和普鲁卡因胺以及其他Ⅲ类药物如胺碘酮，有可能延长不应期，不应与索他洛尔合用
小诺霉素	磺胺嘧啶	药效降低，不良反应增加	小诺霉素不宜与两性霉素B、头孢噻吩钠、呋喃妥因钠、磺胺嘧啶钠和盐酸四环素等（以上均为注射液）联合应用，因可发生配伍禁忌
米力农	丙吡胺	不良反应增加	米力农与丙吡胺同用可导致血压过低
扎来普隆片	乙醇	不良反应增加	乙醇：扎来普隆片可增强乙醇对中枢神经系统的损伤作用，但不影响乙醇的药代动力学
氯普噻吨	肾上腺素	药效降低，不良反应增加	氯普噻吨与肾上腺素合用，由于α-受体活动受阻，β-受体活动占优势，可出现血压下降
氯化钠	吡咯他尼	药效降低，不良反应增加	氯化钠与碱性注射液（如呋喃苯胺酸、甲氨蝶呤、氟尿嘧啶、吡咯他尼注射液）或鬼臼乙叉甙注射液配伍会发生浑浊或结晶析出，故不宜与上述药物同时应用
复方对乙酰氨基酚	巴比妥类	不良反应增加	复方对乙酰氨基酚不应与含有酒精的饮料、巴比妥类(如苯巴比妥)、解痉药类(如颠茄)同服，因可造成肝损害
对乙酰氨基酚	苯巴比妥	不良反应增加	应用巴比妥类(如苯巴比妥)或解痉药(如颠茄)的患者，长期应用对乙酰氨基酚可致肝损害
奥硝唑	雷尼替丁	药效降低，不良反应增加	巴比妥类药、雷尼替丁和西咪替丁等药物可使奥硝唑加速消除而降效并可影响凝血因此应禁忌合用
氯化钠	两性霉素B	药效降低，不良反应增加	氯化钠不宜与两性霉素B、头孢噻吩、呋喃妥英钠、磺胺嘧啶钠和四环素等(以上均为注射液)联合应用，因可发生配伍禁忌
肌苷氯化钠注射液	盐酸山梗菜碱	药效降低，不良反应增加	肌苷氯化钠注射液禁与下列注射液配伍：乳清酸、氯霉素、双嘧达莫、盐酸山梗菜碱、硫酸阿托品、氢溴酸东莨菪碱、盐酸氯丙嗪、盐酸异丙嗪、马来酸麦角新碱、盐酸普鲁卡因、硫喷妥钠、苯妥英钠、氯氮卓、盐酸去甲肾上腺素、盐酸丁卡因、利血平、硝普钠、降压嗪、呋噻米、利尿酸钠、促皮质素、维生素B12、盐酸苯海拉明、马来酸氯苯那敏、细胞色素C、盐酸万古霉素、盐酸四环素、二盐酸奎宁、盐酸阿糖胞苷、硫酸长春新碱以及所有菌苗和疫苗
西索米星氯化钠	磺胺嘧啶	药效降低，不良反应增加	西索米星氯化钠不宜与两性霉素B、头孢噻吩、呋喃妥英钠、磺胺嘧啶钠和四环素等(以上均为注射液)联合应用，因可发生配伍禁忌
头孢米诺	腺苷钴胺	药效降低，不良反应增加	本口与氨茶碱、磷酸吡哆醛配伍会降低效价或着色，故不得配伍；与呋喃硫胺、硫辛酸，氢化可的松琥珀酸钠及腺苷钴胺配伍后时间稍长会变色，故配伍后应尽快使用；与利尿剂呋(呋喃苯胺酸等)等合用有可能增加肾毒性，应谨慎使用，动物实验证实，头孢米诺影响酒精代谢，使血中乙醛浓度上升，显示双硫仑样作用，故用药期间或用药后应禁酒
头孢哌酮	阿米卡星	药效降低，不良反应增加	头孢哌酮与下列药物注射剂有配伍禁忌：阿米卡星、庆大霉素、卡那霉素B、多西环素、甲氯芬酯、阿马林(缓脉灵)、苯海拉明、门冬酸钾镁、盐酸羟嗪(安太乐)、普鲁卡因胺、氨茶碱、丙氯拉嗪、细胞色素C、喷他佐辛(镇痛新)、抑肽酶等
他唑巴坦	利多卡因	药效降低，不良反应增加	他唑巴坦与复方乳酸钠注射液或盐酸利多卡因注射液混合后出现配伍禁忌
肝素	卡那霉素	药效降低，不良反应增加	下列药物与肝素有配伍禁忌：卡那霉素、阿米卡星、柔红霉素、乳糖酸红霉素、硫酸庆大霉素、氢化考的松琥珀酸钠、多粘菌素B、阿霉素、妥布霉素、万古霉素、头孢孟多、头孢氧哌唑、头孢噻吩钠、氯喹、氯丙嗪、异丙嗪、麻醉性镇痛药
氯己定	碘化钾	药效降低，不良反应增加	氯己定与肥皂、碘化钾等配伍禁忌
利福平	达卡巴嗪	药效降低，不良反应增加	利福平可诱导肝微粒酶，增加抗肿瘤药达卡巴嗪，环磷酰胺的代谢，烷化代谢的形成，促使白细胞降低，因此需调整剂量
甲砜霉素	雌激素	药效降低，不良反应增加	长期口服含雌激素的避孕药，如同时服用甲砜霉素，可使避孕的可靠性降低，以及月经期外出血增加
羧苄西林	盐酸土霉素	药效降低，不良反应增加	羧苄西林与琥珀氯霉素、琥乙红霉素、盐酸土霉素、盐酸四环素、卡那霉素、链霉素、庆大霉素、妥布霉素、两性霉素B、维生素B族、维生素C、苯妥英钠、拟交感类药物、异丙嗪等有配伍禁忌
头孢米诺	呋喃硫胺	药效降低，不良反应增加	本口与氨茶碱、磷酸吡哆醛配伍会降低效价或着色，故不得配伍；与呋喃硫胺、硫辛酸，氢化可的松琥珀酸钠及腺苷钴胺配伍后时间稍长会变色，故配伍后应尽快使用；与利尿剂呋(呋喃苯胺酸等)等合用有可能增加肾毒性，应谨慎使用，动物实验证实，头孢米诺影响酒精代谢，使血中乙醛浓度上升，显示双硫仑样作用，故用药期间或用药后应禁酒
奥硝唑	巴比妥类	药效降低，不良反应增加	巴比妥类药、雷尼替丁和西咪替丁等药物可使奥硝唑加速消除而降效并可影响凝血，因此
氯化钠	呋喃苯胺酸	药效降低，不良反应增加	氯化钠与碱性注射液（如呋喃苯胺酸、甲氨蝶呤、氟尿嘧啶、吡咯他尼注射液）或鬼臼乙叉甙注射液配伍会发生浑浊或结晶析出，故不宜与上述药物同时应用
利福平	达卡巴嗪	药效降低，不良反应增加	利福平可诱导肝微粒体酶，增加抗肿瘤药达卡巴嗪(dacarbazine)．环礴酰胺的代谢，形成烷化代谢物，促使白细胞减低，因此需调整剂量
丁胺卡那霉素	两性霉素B	药效降低，不良反应增加	丁胺卡那霉素不宜与两性霉素B、头孢噻吩、磺胺嘧啶和四环素等注射剂联合应用，因可发生配伍禁忌
贝那普利	利尿药	药效降低，不良反应增加	与潴钾利尿药如螺内酯、氨苯喋啶、阿米洛利合用可引起血钾过高4.与非甾体类抗炎止痛药合用可通过抑制前列腺素合成及水钠潴留，使贝那普利降压作用减弱
阿扎司琼	氯化钠注射液	药效降低，不良反应增加	阿扎司琼与碱性注射液(如呋喃苯胺酸、甲氯蝶呤、氟尿嘧啶，吡咯他尼等注射液)或鬼臼乙叉甙注射液配伍会发生浑浊或结晶析出，故需将阿扎司琼先用氯化钠注射液稀释后，方可与上述碱性药物配伍使用
氯化钠	吡咯他尼	药效降低，不良反应增加	氯化钠与碱性药液(如呋喃苯胺酸、甲氨蝶呤、氟尿嘧啶、吡咯他尼等注射液)或鬼臼乙叉苷注射液配伍会发生浑浊或结晶析出
利福平Ⅱ	达卡巴嗪	药效降低，不良反应增加	利福平Ⅱ可诱导肝微粒体酶，增加抗肿瘤药达卡巴嗪(dacarbazine)．环礴酰胺的代谢，形成烷化代谢物，促使白细胞减低，因此需调整剂量
利福平Ⅱ	抗肿瘤药	药效降低，不良反应增加	利福平Ⅱ可诱导肝微粒体酶，增加抗肿瘤药达卡巴嗪(dacarbazine)．环礴酰胺的代谢，形成烷化代谢物，促使白细胞减低，因此需调整剂量
利福霉素	达卡巴嗪	药效降低，不良反应增加	利福霉素可诱导肝微粒体酶，增加抗肿瘤药达卡巴嗪(dacarbazine)、环磷酰胺的代谢，形成烷化代谢物，促使白细胞减低，因此需调整剂量
头孢哌酮	氨茶碱	药效降低，不良反应增加	头孢哌酮与安太乐、普鲁卡因胺、氨茶碱、丙氯拉嗪、细胞色素C、镇痛新、抑肽酶混合后6小时发生外观变化
利福霉素	环磷酰胺	药效降低，不良反应增加	利福霉素可诱导肝微粒体酶，增加抗肿瘤药达卡巴嗪(dacarbazine)﹑环磷酰胺的代谢，形成烷化代谢物，促使白细胞减低，因此需调整剂量
利福平	环磷酰胺	药效降低，不良反应增加	利福平可诱导肝微粒体酶，增加抗肿瘤药达卡巴嗪(dacarbazine)、环磷酰胺的代谢、烷化代谢物的形成，促使白细胞减低，因此需调整剂量
肌苷氯化钠注射液	盐酸丁卡因	药效降低，不良反应增加	肌苷氯化钠注射液禁与下列注射液配伍：乳清酸、氯霉素、双嘧达莫、盐酸山梗菜碱、硫酸阿托品、氢溴酸东莨菪碱、盐酸氯丙嗪、盐酸异丙嗪、马来酸麦角新碱、盐酸普鲁卡因、硫喷妥钠、苯妥英钠、氯氮卓、盐酸去甲肾上腺素、盐酸丁卡因、利血平、硝普钠、降压嗪、呋噻米、利尿酸钠、促皮质素、维生素B12、盐酸苯海拉明、马来酸氯苯那敏、细胞色素C、盐酸万古霉素、盐酸四环素、二盐酸奎宁、盐酸阿糖胞苷、硫酸长春新碱以及所有菌苗和疫苗
利多卡因Ⅰ	甘露醇	药效降低，不良反应增加	与西咪替丁以及β受体阻断剂如，普萘洛尔、美托洛尔、纳多洛尔合用，利多卡因经肝脏代谢受抑制，利多卡因血浓度增加，可发生心脏和神经系统不良反应，应调整利多卡因剂量，并应心电图监护及监测利多卡因血药浓度；(2)巴比妥类药物可促进利多卡因代谢，两药合用可引起心动过缓，窦性停搏；(3)与普鲁卡因胺合用，可产生一过性谵妄及幻觉，但不影响利多卡因Ⅰ血药浓度；(4)异丙基肾上腺素因增加肝血流量，可使利多卡因Ⅰ的总清除率升高；去甲肾上腺素因减少肝血流量，可使利多卡因Ⅰ总清除率下降；(5)与下列药品有配伍禁忌：苯巴比妥，硫喷妥钠，硝普钠，甘露醇，两性霉素B，氨苄西林，磺胺嘧啶
哌嗪	环磷酰胺	药效降低，不良反应增加	哌嗪可诱导肝微粒体酶，增加抗肿瘤药达卡巴嗪(dacarbazine)、环磷酰胺的代谢，形成烷化代谢物，促使白细胞减低，因此需调整剂量
维生素K1	右旋糖酐	药效降低，不良反应增加	维生素K1与苯妥英钠混合2小时后可出现颗粒沉淀，与维生素C、维生素B12、右旋糖酐混合易出现混浊
异福酰胺	抗肿瘤药	药效降低，不良反应增加	异福酰胺可诱导肝微粒体酶，增加抗肿瘤药达卡巴嗪(dacarbazine)、环磷酰胺的代谢，形成烷化代谢物，促使白细胞减低，因此需调整剂量
利福平	达卡巴嗪	药效降低，不良反应增加	利福平可诱导肝微粒体酶，增加抗肿瘤药达卡巴嗪(dacarbazine)﹑环磷酰胺的代谢，形成烷化代谢物，促使白细胞减低，因此需调整剂量
贝那普利	阿米洛利	药效降低，不良反应增加	与潴钾利尿药如螺内酯、氨苯喋啶、阿米洛利合用可引起血钾过高4.与非甾体类抗炎止痛药合用可通过抑制前列腺素合成及水钠潴留，使贝那普利降压作用减弱
氯化钠	两性霉素B	药效降低，不良反应增加	氯化钠不宜与两性霉素B、头孢噻吩钠、呋喃妥因钠，磺胺嘧啶钠和四环素（以上均为注射液）联合应用，因可发生配伍禁忌
奥硝唑	萘夫西林	药效降低，不良反应增加	奥硝唑与呋布西林钠、萘夫西林钠、奥美拉唑、沃必唑、注射用炎琥宁、阿洛西林钠存在配伍禁忌
肌苷氯化钠注射液	呋噻米	药效降低，不良反应增加	肌苷氯化钠注射液禁与下列注射液配伍：乳清酸、氯霉素、双嘧达莫、盐酸山梗菜碱、硫酸阿托品、氢溴酸东莨菪碱、盐酸氯丙嗪、盐酸异丙嗪、马来酸麦角新碱、盐酸普鲁卡因、硫喷妥钠、苯妥英钠、氯氮卓、盐酸去甲肾上腺素、盐酸丁卡因、利血平、硝普钠、降压嗪、呋噻米、利尿酸钠、促皮质素、维生素B12、盐酸苯海拉明、马来酸氯苯那敏、细胞色素C、盐酸万古霉素、盐酸四环素、二盐酸奎宁、盐酸阿糖胞苷、硫酸长春新碱以及所有菌苗和疫苗
氯化钠	头孢噻吩	药效降低，不良反应增加	氯化钠不宜与两性霉素B、头孢噻吩、呋喃妥英钠、磺胺嘧啶钠和四环素等(以上均为注射液)联合应用，因可发生配伍禁忌
小诺霉素	两性霉素B	药效降低，不良反应增加	小诺霉素不宜与两性霉素B、头孢噻吩钠、呋喃妥因钠、磺胺嘧啶钠和盐酸四环素等（以上均为注射液）联合应用，因可发生配伍禁忌
甲砜霉素肠溶片	雌激素	药效降低，不良反应增加	长期口服含雌激素的避孕药，如同时服用甲砜霉素肠溶片，可使避孕的可靠性降低，以及月经期外出血增加
西索米星	呋喃妥因	药效降低，不良反应增加	西索米星不宜与两性霉素B、头孢噻吩钠、呋喃妥因钠，磺胺嘧啶钠和四环素（以上均为注射液）联合应用，因可发生配伍禁忌
肝素	镇痛药	药效降低，不良反应增加	下列药物与肝素有配伍禁忌：卡那霉素、阿米卡星、柔红霉素、乳糖酸红霉素、硫酸庆大霉素、氢化考的松琥珀酸钠、多粘菌素B、阿霉素、妥布霉素、万古霉素、头孢孟多、头孢氧哌唑、头孢噻吩钠、氯喹丙嗪、异丙嗪、麻醉性镇痛药
利多卡因Ⅰ	美托洛尔	药效降低，不良反应增加	与西咪替丁以及β受体阻断剂如，普萘洛尔、美托洛尔、纳多洛尔合用，利多卡因经肝脏代谢受抑制，利多卡因血浓度增加，可发生心脏和神经系统不良反应，应调整利多卡因剂量，并应心电图监护及监测利多卡因血药浓度；(2)巴比妥类药物可促进利多卡因代谢，两药合用可引起心动过缓，窦性停搏；(3)与普鲁卡因胺合用，可产生一过性谵妄及幻觉，但不影响利多卡因Ⅰ血药浓度；(4)异丙基肾上腺素因增加肝血流量，可使利多卡因Ⅰ的总清除率升高；去甲肾上腺素因减少肝血流量，可使利多卡因Ⅰ总清除率下降；(5)与下列药品有配伍禁忌：苯巴比妥，硫喷妥钠，硝普钠，甘露醇，两性霉素B，氨苄西林，磺胺嘧啶
肝素	卡那霉素	药效降低，不良反应增加	下列药物与肝素有配伍禁忌：卡那霉素、阿米卡星、柔红霉素、乳糖酸红霉素、硫酸庆大霉素、氢化考的松琥珀酸钠、多粘菌素B、阿霉素、妥布霉素、万古霉素、头孢孟多、头孢氧哌唑、头孢噻吩钠、氯喹丙嗪、异丙嗪、麻醉性镇痛药
氯化钠	呋喃妥因	药效降低，不良反应增加	氯化钠不宜与两性霉素B、头孢噻吩钠、呋喃妥因钠，磺胺嘧啶钠和四环素（以上均为注射液）联合应用，因可发生配伍禁忌
硫酸奎尼丁片	抗凝药	药效降低，不良反应增加	2.与口服抗凝药合用可使凝血酶原进一步减少，也可减少硫酸奎尼丁片与蛋白的结合
氯化钠	氟尿嘧啶	药效降低，不良反应增加	氯化钠与碱性药液(如呋喃苯胺酸、甲氨蝶呤、氟尿嘧啶、吡咯他尼等注射液)或鬼臼乙叉苷注射液配伍会发生浑浊或结晶析出
西索米星	四环素	药效降低，不良反应增加	西索米星不宜与两性霉素B、头孢噻吩、呋喃妥英钠、磺胺嘧啶钠和四环素等(以上均为注射液)联合应用，因可发生配伍禁忌
复方氨酚愈敏	马普替林	药效降低，不良反应增加	与三环类抗抑郁药如马普替林同用时，降低复方氨酚愈敏的加压作用
肌苷氯化钠注射液	硫酸阿托品	药效降低，不良反应增加	肌苷氯化钠注射液禁与下列注射液配伍：乳清酸、氯霉素、双嘧达莫、盐酸山梗菜碱、硫酸阿托品、氢溴酸东莨菪碱、盐酸氯丙嗪、盐酸异丙嗪、马来酸麦角新碱、盐酸普鲁卡因、硫喷妥钠、苯妥英钠、氯氮卓、盐酸去甲肾上腺素、盐酸丁卡因、利血平、硝普钠、降压嗪、呋噻米、利尿酸钠、促皮质素、维生素B12、盐酸苯海拉明、马来酸氯苯那敏、细胞色素C、盐酸万古霉素、盐酸四环素、二盐酸奎宁、盐酸阿糖胞苷、硫酸长春新碱以及所有菌苗和疫苗
吡罗昔康	阿司匹林	药效降低，不良反应增加	阿司匹林同用时，吡罗昔康的血药浓度可下降到一般浓度的80%，同时胃肠道溃疡形成和出血倾向的危险性增加
利多卡因Ⅰ	氨苄西林	药效降低，不良反应增加	与西咪替丁以及β受体阻断剂如，普萘洛尔、美托洛尔、纳多洛尔合用，利多卡因经肝脏代谢受抑制，利多卡因血浓度增加，可发生心脏和神经系统不良反应，应调整利多卡因剂量，并应心电图监护及监测利多卡因血药浓度；(2)巴比妥类药物可促进利多卡因代谢，两药合用可引起心动过缓，窦性停搏；(3)与普鲁卡因胺合用，可产生一过性谵妄及幻觉，但不影响利多卡因Ⅰ血药浓度；(4)异丙基肾上腺素因增加肝血流量，可使利多卡因Ⅰ的总清除率升高；去甲肾上腺素因减少肝血流量，可使利多卡因Ⅰ总清除率下降；(5)与下列药品有配伍禁忌：苯巴比妥，硫喷妥钠，硝普钠，甘露醇，两性霉素B，氨苄西林，磺胺嘧啶
小儿复方磺胺嘧啶	雌激素	药效降低，不良反应增加	与避孕药（口服含雌激素者），同时长时间应用小儿复方磺胺嘧啶可导致避孕的可靠性减少，并增加经期外出血的机会
西索米星	两性霉素B	药效降低，不良反应增加	西索米星不宜与两性霉素B、头孢噻吩、呋喃妥英钠、磺胺嘧啶钠和四环素等(以上均为注射液)联合应用，因可发生配伍禁忌
肌苷氯化钠注射液	利尿酸钠	药效降低，不良反应增加	肌苷氯化钠注射液禁与下列注射液配伍：乳清酸、氯霉素、双嘧达莫、盐酸山梗菜碱、硫酸阿托品、氢溴酸东莨菪碱、盐酸氯丙嗪、盐酸异丙嗪、马来酸麦角新碱、盐酸普鲁卡因、硫喷妥钠、苯妥英钠、氯氮卓、盐酸去甲肾上腺素、盐酸丁卡因、利血平、硝普钠、降压嗪、呋噻米、利尿酸钠、促皮质素、维生素B12、盐酸苯海拉明、马来酸氯苯那敏、细胞色素C、盐酸万古霉素、盐酸四环素、二盐酸奎宁、盐酸阿糖胞苷、硫酸长春新碱以及所有菌苗和疫苗
吡罗昔康	阿司匹林	药效降低，不良反应增加	与阿司匹林同用时，吡罗昔康的血药浓度可下降到一般浓度的80%，同时胃肠道溃疡形成和出血倾向的危险性增加
麻黄碱	呋喃妥因	药效降低，不良反应增加	麻黄碱与磺胺嘧啶，呋喃妥因等呈配伍禁忌
胰岛素	甲氨喋呤	药效降低，不良反应增加	抗凝血药、水杨酸盐、磺胺类药及抗肿瘤药甲氨喋呤等可与胰岛素竞争和血浆蛋白结合，从而使血液中游离胰岛素水平增高
舒巴坦	头孢哌酮	药效降低，不良反应增加	由于头孢哌酮/舒巴坦与氨基糖苷类抗生素之间有物理性配伍禁忌，因此两种药液不能直接混合
利福平滴眼液	抗肿瘤药	药效降低，不良反应增加	利福平滴眼液可诱导肝微粒体酶，增加抗肿瘤药达卡巴嗪(dacarbazine)﹑环磷酰胺的代谢，形成烷化代谢物，促使白细胞减低，因此需调整剂量
氯己定	碘化钾	药效降低，不良反应增加	氯己定与肥皂，碘化钾等有配伍禁忌
利福平	抗肿瘤药	药效降低，不良反应增加	利福平可诱导肝微粒酶，增加抗肿瘤药达卡巴嗪，环磷酰胺的代谢，烷化代谢的形成，促使白细胞降低，因此需调整剂量
头孢哌酮	丙氯拉嗪	药效降低，不良反应增加	头孢哌酮与安太乐、普鲁卡因胺、氨茶碱、丙氯拉嗪、细胞色素C、镇痛新、抑肽酶混合后1/2小时发生外观变化
维生素K	维生素C	药效降低，不良反应增加	维生素K与苯妥英钠混合2小时后可出现颗粒沉淀，与维生素C、维生素B12、右旋糖酐混合易出现混浊
头孢哌酮	普鲁卡因胺	药效降低，不良反应增加	头孢哌酮与安太乐、普鲁卡因胺、氨茶碱、丙氯拉嗪、细胞色素C、镇痛新、抑肽酶混合后6小时发生外观变化
肝素	庆大霉素	药效降低，不良反应增加	下列药物与肝素有配伍禁忌：卡那霉素、阿米卡星、柔红霉素、乳糖酸红霉素、硫酸庆大霉素、氢化考的松琥珀酸钠、多粘菌素B、阿霉素、妥布霉素、万古霉素、头孢孟多、头孢氧哌唑、头孢噻吩钠、氯喹丙嗪、异丙嗪、麻醉性镇痛药
利福喷丁	抗肿瘤药	药效降低，不良反应增加	利福喷丁可诱导肝微粒体酶，增加抗肿瘤药达卡巴嗪(dacarbazine)、环磷酰胺的代谢，形成烷化代谢物，促使白细胞减低，因此需调整剂量
氯化钠	四环素	药效降低，不良反应增加	氯化钠不宜与两性霉素B、头孢噻吩钠、呋喃妥因钠，磺胺嘧啶钠和四环素（以上均为注射液）联合应用，因可发生配伍禁忌
肝素	头孢噻吩	药效降低，不良反应增加	下列药物与肝素有配伍禁忌：卡那霉素、阿米卡星、柔红霉素、乳糖酸红霉素、硫酸庆大霉素、氢化考的松琥珀酸钠、多粘菌素B、阿霉素、妥布霉素、万古霉素、头孢孟多、头孢氧哌唑、头孢噻吩钠、氯喹、氯丙嗪、异丙嗪、麻醉性镇痛药
西索米星氯化钠	酰胺类	药效降低，不良反应增加	西索米星氯化钠与β-内酰胺类(头孢菌素类或青霉素)混合可导致相互失活，需联合应用时必须分瓶注射
羧苄西林	妥布霉素	药效降低，不良反应增加	羧苄西林与琥珀氯霉素、琥乙红霉素、盐酸土霉素、盐酸四环素、卡那霉素、链霉素、庆大霉素、妥布霉素、两性霉素B、维生素B族、维生素C、苯妥英钠、拟交感类药物、异丙嗪等有配伍禁忌
肝素	妥布霉素	药效降低，不良反应增加	下列药物与肝素有配伍禁忌：卡那霉素、阿米卡星、柔红霉素、乳糖酸红霉素、硫酸庆大霉素、氢化考的松琥珀酸钠、多粘菌素B、阿霉素、妥布霉素、万古霉素、头孢孟多、头孢氧哌唑、头孢噻吩钠、氯喹丙嗪、异丙嗪、麻醉性镇痛药
奥硝唑	呋布西林	药效降低，不良反应增加	文献报道，奥硝唑与呋布西林钠、萘夫西林钠、奥美拉唑、沃必唑、注射用炎琥宁、阿洛西林钠存在配伍禁忌，左奥硝唑在使用时也应注意
利多卡因Ⅰ	纳多洛尔	药效降低，不良反应增加	与西咪替丁以及β受体阻断剂如，普萘洛尔、美托洛尔、纳多洛尔合用，利多卡因经肝脏代谢受抑制，利多卡因血浓度增加，可发生心脏和神经系统不良反应，应调整利多卡因剂量，并应心电图监护及监测利多卡因血药浓度；(2)巴比妥类药物可促进利多卡因代谢，两药合用可引起心动过缓，窦性停搏；(3)与普鲁卡因胺合用，可产生一过性谵妄及幻觉，但不影响利多卡因Ⅰ血药浓度；(4)异丙基肾上腺素因增加肝血流量，可使利多卡因Ⅰ的总清除率升高；去甲肾上腺素因减少肝血流量，可使利多卡因Ⅰ总清除率下降；(5)与下列药品有配伍禁忌：苯巴比妥，硫喷妥钠，硝普钠，甘露醇，两性霉素B，氨苄西林，磺胺嘧啶
利福平Ⅱ	达卡巴嗪	药效降低，不良反应增加	利福平Ⅱ可诱导肝微粒体酶，增加抗肿瘤药达卡巴嗪(dacarbazine)﹑环磷酰胺的代谢，形成烷化代谢物，促使白细胞减低，因此需调整剂量
氯化钠	头孢噻吩	药效降低，不良反应增加	氯化钠不宜与两性霉素B、头孢噻吩钠、呋喃妥因钠，磺胺嘧啶钠和四环素（以上均为注射液）联合应用，因可发生配伍禁忌
头孢哌酮	丙氯拉嗪	药效降低，不良反应增加	头孢哌酮与下列药物注射剂有配伍禁忌：阿米卡星、庆大霉素、卡那霉素B、多西环素、甲氯芬酯、阿马林(缓脉灵)、苯海拉明、门冬酸钾镁、盐酸羟嗪(安太乐)、普鲁卡因胺、氨茶碱、丙氯拉嗪、细胞色素C、喷他佐辛(镇痛新)、抑肽酶等
肝素	多粘菌素B	药效降低，不良反应增加	下列药物与肝素有配伍禁忌：卡那霉素、阿米卡星、柔红霉素、乳糖酸红霉素、硫酸庆大霉素、氢化考的松琥珀酸钠、多粘菌素B、阿霉素、妥布霉素、万古霉素、头孢孟多、头孢氧哌唑、头孢噻吩钠、氯喹、氯丙嗪、异丙嗪、麻醉性镇痛药
肝素	异丙嗪	药效降低，不良反应增加	下列药物与肝素有配伍禁忌：卡那霉素、阿米卡星、柔红霉素、乳糖酸红霉素、硫酸庆大霉素、氢化考的松琥珀酸钠、多粘菌素B、阿霉素、妥布霉素、万古霉素、头孢孟多、头孢氧哌唑、头孢噻吩钠、氯喹丙嗪、异丙嗪、麻醉性镇痛药
西索米星氯化钠	两性霉素B	药效降低，不良反应增加	西索米星氯化钠不宜与两性霉素B、头孢噻吩、呋喃妥英钠、磺胺嘧啶钠和四环素等(以上均为注射液)联合应用，因可发生配伍禁忌
西索米星氯化钠	四环素	药效降低，不良反应增加	西索米星氯化钠不宜与两性霉素B、头孢噻吩、呋喃妥英钠、磺胺嘧啶钠和四环素等(以上均为注射液)联合应用，因可发生配伍禁忌
奥硝唑	巴比妥类	药效降低，不良反应增加	巴比妥类药、雷尼替丁和西咪替丁等药物可使奥硝唑加速消除而降效并可影响凝血，因此应禁忌合用
西索米星	两性霉素B	药效降低，不良反应增加	西索米星不宜与两性霉素B、头孢噻吩钠、呋喃妥因钠、磺胺嘧啶钠和四环素等（以上均为注射液）联合应用，因可发生配伍禁忌
奥硝唑	炎琥宁	药效降低，不良反应增加	奥硝唑与呋布西林钠、萘夫西林钠、奥美拉唑、沃必唑、注射用炎琥宁、阿洛西林钠存在配伍禁忌
肌苷氯化钠注射液	硝普钠	药效降低，不良反应增加	肌苷氯化钠注射液禁与下列注射液配伍：乳清酸、氯霉素、双嘧达莫、盐酸山梗菜碱、硫酸阿托品、氢溴酸东莨菪碱、盐酸氯丙嗪、盐酸异丙嗪、马来酸麦角新碱、盐酸普鲁卡因、硫喷妥钠、苯妥英钠、氯氮卓、盐酸去甲肾上腺素、盐酸丁卡因、利血平、硝普钠、降压嗪、呋噻米、利尿酸钠、促皮质素、维生素B12、盐酸苯海拉明、马来酸氯苯那敏、细胞色素C、盐酸万古霉素、盐酸四环素、二盐酸奎宁、盐酸阿糖胞苷、硫酸长春新碱以及所有菌苗和疫苗
卡马西平	对乙酰氨基酚	药效降低，不良反应增加	卡马西平与对乙酰氨基酚合用，尤其是单次超量或长期大量，肝脏中毒的危险增加，有可能使后者疗效降低
小诺霉素	头孢噻吩	药效降低，不良反应增加	诺霉素不宜与两性霉素B、头孢噻吩钠、呋喃妥因钠、磺胺嘧啶钠和盐酸四环素等（以上均为注射液）联合应用，因可发生配伍禁忌
肌苷氯化钠注射液	盐酸苯海拉明	药效降低，不良反应增加	肌苷氯化钠注射液禁与下列注射液配伍：乳清酸、氯霉素、双嘧达莫、盐酸山梗菜碱、硫酸阿托品、氢溴酸东莨菪碱、盐酸氯丙嗪、盐酸异丙嗪、马来酸麦角新碱、盐酸普鲁卡因、硫喷妥钠、苯妥英钠、氯氮卓、盐酸去甲肾上腺素、盐酸丁卡因、利血平、硝普钠、降压嗪、呋噻米、利尿酸钠、促皮质素、维生素B12、盐酸苯海拉明、马来酸氯苯那敏、细胞色素C、盐酸万古霉素、盐酸四环素、二盐酸奎宁、盐酸阿糖胞苷、硫酸长春新碱以及所有菌苗和疫苗
环丝氨酸	酒精	药效降低，不良反应增加	酒精与环丝氨酸存在配伍禁忌，特别是大量服用环丝氨酸时，酒精可增加癫痫发作的可能性和危险性
氯化钠	甲氨蝶呤	药效降低，不良反应增加	氯化钠与碱性药液(如呋喃苯胺酸、甲氨蝶呤、氟尿嘧啶、吡咯他尼等注射液)或鬼臼乙叉苷注射液配伍会发生浑浊或结晶析出
西索米星氯化钠	呋喃妥因	药效降低，不良反应增加	西索米星氯化钠不宜与两性霉素B、头孢噻吩钠、呋喃妥因钠，磺胺嘧啶钠和四环素（以上均为注射液）联合应用，因可发生配伍禁忌
丁胺卡那霉素	头孢噻吩	药效降低，不良反应增加	丁胺卡那霉素不宜与两性霉素B、头孢噻吩、磺胺嘧啶和四环素等注射剂联合应用，因可发生配伍禁忌
雷米普利	非甾体抗炎药	药效降低，不良反应增加	－非甾体抗炎药物、止痛剂（如消炎痛、乙酰水杨酸）：可能减弱雷米普利的降压效果；还可能增加肾功能损害和血清钾浓度升高的危险
奥硝唑	雷尼替丁	药效降低，不良反应增加	巴比妥类药、雷尼替丁和西咪替丁等药物可使奥硝唑加速消除而降效并可影响凝血，因此
舒巴坦	氨基糖苷类抗生素	药效降低，不良反应增加	但舒巴坦与氨基糖苷类抗生素之间存在物理性配伍禁忌，因此两种药液不能直接混合
奥硝唑	巴比妥类	药效降低，不良反应增加	巴比妥类药、雷尼替丁和西咪替丁等药物可使奥硝唑加速消除而降效并可影响凝血因此应禁忌合用
西索米星	磺胺嘧啶	药效降低，不良反应增加	西索米星不宜与两性霉素B、头孢噻吩、呋喃妥英钠、磺胺嘧啶钠和四环素等(以上均为注射液)联合应用，因可发生配伍禁忌
肝素	异丙嗪	药效降低，不良反应增加	下列药物与肝素有配伍禁忌：卡那霉素、阿米卡星、柔红霉素、乳糖酸红霉素、硫酸庆大霉素、氢化考的松琥珀酸钠、多粘菌素B、阿霉素、妥布霉素、万古霉素、头孢孟多、头孢氧哌唑、头孢噻吩钠、氯喹、氯丙嗪、异丙嗪、麻醉性镇痛药
贝那普利	氨苯喋啶	药效降低，不良反应增加	与潴钾利尿药如螺内酯、氨苯喋啶、阿米洛利合用可引起血钾过高4.与非甾体类抗炎止痛药合用可通过抑制前列腺素合成及水钠潴留，使贝那普利降压作用减弱
肌苷氯化钠注射液	降压嗪	药效降低，不良反应增加	肌苷氯化钠注射液禁与下列注射液配伍：乳清酸、氯霉素、双嘧达莫、盐酸山梗菜碱、硫酸阿托品、氢溴酸东莨菪碱、盐酸氯丙嗪、盐酸异丙嗪、马来酸麦角新碱、盐酸普鲁卡因、硫喷妥钠、苯妥英钠、氯氮卓、盐酸去甲肾上腺素、盐酸丁卡因、利血平、硝普钠、降压嗪、呋噻米、利尿酸钠、促皮质素、维生素B12、盐酸苯海拉明、马来酸氯苯那敏、细胞色素C、盐酸万古霉素、盐酸四环素、二盐酸奎宁、盐酸阿糖胞苷、硫酸长春新碱以及所有菌苗和疫苗
舒巴坦	头孢哌酮	药效降低，不良反应增加	由于头孢哌酮／舒巴坦与氨基糖苷类抗生素之间有物理性配伍禁忌，直接混合抗菌活性下降，故不能在同一容器中使用
氯化钠	吡咯他尼	药效降低，不良反应增加	氯化钠与碱性注射液(如呋喃苯胺酸、甲氨蝶呤、氟尿嘧啶、吡咯他尼注射液)或鬼臼乙叉甙注射液配伍会发生浑浊或结晶析出，应避免配伍使用
氯唑西林	去甲肾上腺素	药效降低，不良反应增加	氯唑西林与氨基糖苷类、去甲肾上腺素、间羟胺、苯巴比妥、维生素B族、维生素C等药物存在配伍禁忌，不宜同瓶滴注
头孢哌酮	丙氯拉嗪	药效降低，不良反应增加	头孢哌酮与安太乐、普鲁卡因胺、氨茶碱、丙氯拉嗪、细胞色素C、镇痛新、抑肽酶混合后6小时发生外观变化
利福平	达卡巴嗪	药效降低，不良反应增加	利福平可诱导肝微粒体酶，增加抗肿瘤药达卡巴嗪、环磷酰胺的代谢，烷化代谢物的形成，促使白细胞降低，因此需调整剂量
氨苄西林	间羟胺	药效降低，不良反应增加	氨苄西林与氨基糖苷类、去甲肾上腺素、间羟胺、苯巴比妥、维生素B族、维生素C等药物存在配伍禁忌，不宜同瓶滴注
肝素	头孢孟多	药效降低，不良反应增加	下列药物与肝素有配伍禁忌：卡那霉素、阿米卡星、柔红霉素、乳糖酸红霉素、硫酸庆大霉素、氢化考的松琥珀酸钠、多粘菌素B、阿霉素、妥布霉素、万古霉素、头孢孟多、头孢氧哌唑、头孢噻吩钠、氯喹、氯丙嗪、异丙嗪、麻醉性镇痛药
利福平	抗肿瘤药	药效降低，不良反应增加	利福平可诱导肝微粒体酶，增加抗肿瘤药达卡巴嗪(dacarbazine)．环礴酰胺的代谢，形成烷化代谢物，促使白细胞减低，因此需调整剂量
利多卡因Ⅰ	硫喷妥钠	药效降低，不良反应增加	与西咪替丁以及β受体阻断剂如，普萘洛尔、美托洛尔、纳多洛尔合用，利多卡因经肝脏代谢受抑制，利多卡因血浓度增加，可发生心脏和神经系统不良反应，应调整利多卡因剂量，并应心电图监护及监测利多卡因血药浓度；(2)巴比妥类药物可促进利多卡因代谢，两药合用可引起心动过缓，窦性停搏；(3)与普鲁卡因胺合用，可产生一过性谵妄及幻觉，但不影响利多卡因Ⅰ血药浓度；(4)异丙基肾上腺素因增加肝血流量，可使利多卡因Ⅰ的总清除率升高；去甲肾上腺素因减少肝血流量，可使利多卡因Ⅰ总清除率下降；(5)与下列药品有配伍禁忌：苯巴比妥，硫喷妥钠，硝普钠，甘露醇，两性霉素B，氨苄西林，磺胺嘧啶
头孢哌酮	喷他佐辛	药效降低，不良反应增加	头孢哌酮与下列药物注射剂有配伍禁忌：阿米卡星、庆大霉素、卡那霉素B、多西环素、甲氯芬酯、阿马林(缓脉灵)、苯海拉明、门冬酸钾镁、盐酸羟嗪(安太乐)、普鲁卡因胺、氨茶碱、丙氯拉嗪、细胞色素C、喷他佐辛(镇痛新)、抑肽酶等
舒巴坦	利多卡因	药效降低，不良反应增加	舒巴坦与复方乳酸钠注射液或盐酸利多卡因注射液混合后出现配伍禁忌
利多卡因Ⅰ	普萘洛尔	药效降低，不良反应增加	与西咪替丁以及β受体阻断剂如，普萘洛尔、美托洛尔、纳多洛尔合用，利多卡因经肝脏代谢受抑制，利多卡因血浓度增加，可发生心脏和神经系统不良反应，应调整利多卡因剂量，并应心电图监护及监测利多卡因血药浓度；(2)巴比妥类药物可促进利多卡因代谢，两药合用可引起心动过缓，窦性停搏；(3)与普鲁卡因胺合用，可产生一过性谵妄及幻觉，但不影响利多卡因Ⅰ血药浓度；(4)异丙基肾上腺素因增加肝血流量，可使利多卡因Ⅰ的总清除率升高；去甲肾上腺素因减少肝血流量，可使利多卡因Ⅰ总清除率下降；(5)与下列药品有配伍禁忌：苯巴比妥，硫喷妥钠，硝普钠，甘露醇，两性霉素B，氨苄西林，磺胺嘧啶
氯霉素	雌激素	药效降低，不良反应增加	期使用含雌激素的避孕药，如同时使用氯霉素，可使避孕的可靠性降低，以及经期外出血增加
西索米星氯化钠	头孢噻吩	药效降低，不良反应增加	西索米星氯化钠不宜与两性霉素B、头孢噻吩钠、呋喃妥因钠，磺胺嘧啶钠和四环素（以上均为注射液）联合应用，因可发生配伍禁忌
羧苄西林	庆大霉素	药效降低，不良反应增加	羧苄西林与琥珀氯霉素、琥乙红霉素、盐酸土霉素、盐酸四环素、卡那霉素、链霉素、庆大霉素、妥布霉素、两性霉素B、维生素B族、维生素C、苯妥英钠、拟交感类药物、异丙嗪等有配伍禁忌
头孢哌酮	羟嗪	药效降低，不良反应增加	头孢哌酮与下列药物注射剂有配伍禁忌：阿米卡星、庆大霉素、卡那霉素B、多西环素、甲氯芬酯、阿马林(缓脉灵)、苯海拉明、门冬酸钾镁、盐酸羟嗪(安太乐)、普鲁卡因胺、氨茶碱、丙氯拉嗪、细胞色素C、喷他佐辛(镇痛新)、抑肽酶等
利福平Ⅱ	环磷酰胺	药效降低，不良反应增加	利福平Ⅱ可诱导肝微粒体酶，增加抗肿瘤药达卡巴嗪(dacarbazine)﹑环磷酰胺的代谢，形成烷化代谢物，促使白细胞减低，因此需调整剂量
利福平Ⅱ	环磷酰胺	药效降低，不良反应增加	利福平Ⅱ可诱导肝微粒体酶，增加抗肿瘤药达卡巴嗪(dacarbazine)、环磷酰胺的代谢，形成烷化代谢物，促使白细胞减低，因此需调整剂量
奥硝唑	西咪替丁	药效降低，不良反应增加	巴比妥类药、雷尼替丁和西咪替丁等药物可使奥硝唑加速消除而降效并可影响凝血，因此
舒巴坦	氨基糖苷类抗生素	药效降低，不良反应增加	由于头孢哌酮/舒巴坦与氨基糖苷类抗生素之间有物理性配伍禁忌，因此两种药液不能直接混合
氯化钠	甲氨蝶呤	药效降低，不良反应增加	氯化钠与碱性注射液（如呋喃苯胺酸、甲氨蝶呤、氟尿嘧啶、吡咯他尼注射液）或鬼臼乙叉甙注射液配伍会发生浑浊或结晶析出，故不宜与上述药物同时应用
奥硝唑	西咪替丁	药效降低，不良反应增加	巴比妥类药、雷尼替丁和西咪替丁等药物可使奥硝唑加速消除而降效并可影响凝血，因此应禁忌合用
甲砜霉素	雌激素	药效降低，不良反应增加	长期口服含雌激素的避孕药者同时服用甲砜霉素时，可使避孕的可靠性降低，以及经期外出血增加
呋喃妥因	丙磺舒	药效降低，不良反应增加	丙磺舒和苯磺唑酮均可抑制呋喃妥因的肾小管分泌，导致后者的血药浓度增高和(或)血清半衰期延长，而尿浓度则见降低，疗效亦减弱
苯唑西林	去甲肾上腺素	药效降低，不良反应增加	苯唑西林与氨基糖苷类、去甲肾上腺素、间羟胺、苯巴比妥、维生素B族、维生素C等药物存在配伍禁忌，不宜同瓶滴注
异福酰胺	环磷酰胺	药效降低，不良反应增加	异福酰胺可诱导肝微粒体酶，增加抗肿瘤药达卡巴嗪(dacarbazine)、环磷酰胺的代谢，形成烷化代谢物，促使白细胞减低，因此需调整剂量
肝素	妥布霉素	药效降低，不良反应增加	下列药物与肝素有配伍禁忌：卡那霉素、阿米卡星、柔红霉素、乳糖酸红霉素、硫酸庆大霉素、氢化考的松琥珀酸钠、多粘菌素B、阿霉素、妥布霉素、万古霉素、头孢孟多、头孢氧哌唑、头孢噻吩钠、氯喹、氯丙嗪、异丙嗪、麻醉性镇痛药
肝素	庆大霉素	药效降低，不良反应增加	下列药物与肝素有配伍禁忌：卡那霉素、阿米卡星、柔红霉素、乳糖酸红霉素、硫酸庆大霉素、氢化考的松琥珀酸钠、多粘菌素B、阿霉素、妥布霉素、万古霉素、头孢孟多、头孢氧哌唑、头孢噻吩钠、氯喹、氯丙嗪、异丙嗪、麻醉性镇痛药
头孢哌酮	利多卡因	药效降低，不良反应增加	由于头孢哌酮与2％盐酸利多卡因注射液混合后有配伍禁忌，因此应避免在最初溶解时使用此溶液
氯唑西林	维生素C	药效降低，不良反应增加	氯唑西林与氨基糖苷类、去甲肾上腺素、间羟胺、苯巴比妥、维生素B族、维生素C等药物存在配伍禁忌，不宜同瓶滴注
青霉素	间羟胺	药效降低，不良反应增加	青霉素与氨基糖苷类、去甲肾上腺素、间羟胺、苯巴比妥、维生素B族、维生素C等药物存在配伍禁忌，不宜同瓶滴注
阿米卡星	四环素	药效降低，不良反应增加	阿米卡星不宜与两性霉素B、头孢噻吩、磺胺嘧啶和四环素等注射剂联合应用，因可发生配伍禁忌
丁胺卡那霉素	磺胺嘧啶	药效降低，不良反应增加	丁胺卡那霉素不宜与两性霉素B、头孢噻吩、磺胺嘧啶和四环素等注射剂联合应用，因可发生配伍禁忌
氢氯噻嗪	间羟胺	药效降低，不良反应增加	与拟交感类药同用使氢氯噻嗪的降压作用减弱，也可使拟交感类药的升压作用增强，间羟胺与氢氯噻嗪同用可至高血压危象
萘夫西林	氨基糖苷类	药效降低，不良反应增加	萘夫西林与氨基糖苷类、去甲肾上腺素、间羟胺、苯巴比妥、维生素B族、维生素C等药物存在配伍禁忌，不宜同瓶滴注
奥硝唑	奥美拉唑	药效降低，不良反应增加	奥硝唑与呋布西林钠、萘夫西林钠、奥美拉唑、沃必唑、注射用炎琥宁、阿洛西林钠存在配伍禁忌
头孢孟多	复方氯化钠注射液	药效降低，不良反应增加	头孢孟多制剂中含有碳酸钠，因而与含有钙或镁的溶液（包括复方氯化钠注射液或复方乳酸钠注射液）有配伍禁忌
利福平滴眼液	达卡巴嗪	药效降低，不良反应增加	利福平滴眼液可诱导肝微粒体酶，增加抗肿瘤药达卡巴嗪(dacarbazine)﹑环磷酰胺的代谢，形成烷化代谢物，促使白细胞减低，因此需调整剂量
利福定	抗肿瘤药	药效降低，不良反应增加	利福定可诱导肝微粒体酶，增加抗肿瘤药达卡巴嗪(dacarbazine)、环磷酰胺的代谢，形成烷化代谢物，促使白细胞减低，因此需调整剂量
肌苷氯化钠注射液	双嘧达莫	药效降低，不良反应增加	肌苷氯化钠注射液禁与下列注射液配伍：乳清酸、氯霉素、双嘧达莫、盐酸山梗菜碱、硫酸阿托品、氢溴酸东莨菪碱、盐酸氯丙嗪、盐酸异丙嗪、马来酸麦角新碱、盐酸普鲁卡因、硫喷妥钠、苯妥英钠、氯氮卓、盐酸去甲肾上腺素、盐酸丁卡因、利血平、硝普钠、降压嗪、呋噻米、利尿酸钠、促皮质素、维生素B12、盐酸苯海拉明、马来酸氯苯那敏、细胞色素C、盐酸万古霉素、盐酸四环素、二盐酸奎宁、盐酸阿糖胞苷、硫酸长春新碱以及所有菌苗和疫苗
氯化钠	四环素	药效降低，不良反应增加	氯化钠不宜与两性霉素B、头孢噻吩、呋喃妥英钠、磺胺嘧啶钠和四环素等(以上均为注射液)联合应用，因可发生配伍禁忌
妥拉唑啉	甲氧明	药效降低，不良反应增加	应用妥拉唑啉后，再应用甲氧明或去甲肾上腺素将阻滞后者的升压作用，可能出现严重的低血压
肝素	多粘菌素B	药效降低，不良反应增加	下列药物与肝素有配伍禁忌：卡那霉素、阿米卡星、柔红霉素、乳糖酸红霉素、硫酸庆大霉素、氢化考的松琥珀酸钠、多粘菌素B、阿霉素、妥布霉素、万古霉素、头孢孟多、头孢氧哌唑、头孢噻吩钠、氯喹丙嗪、异丙嗪、麻醉性镇痛药
利福平	抗肿瘤药	药效降低，不良反应增加	利福平可诱导肝微粒体酶，增加抗肿瘤药达卡巴嗪、环磷酰胺的代谢，烷化代谢物的形成，促使白细胞降低，因此需调整剂量
维生素K	右旋糖酐	药效降低，不良反应增加	维生素K与苯妥英钠混合2小时后可出现颗粒沉淀，与维生素C、维生素B12、右旋糖酐混合易出现混浊
复方磷酸可待因	茶碱	药效降低，不良反应增加	复方磷酸可待因与茶碱合用，不良反应增多，使后者的疗效降低
卡那霉素	四环素	药效降低，不良反应增加	卡那霉素不宜与两性霉素B、头孢噻吩、磺胺嘧啶和四环素等注射剂联合应用，因可发生配伍禁忌
肝素	阿霉素	药效降低，不良反应增加	下列药物与肝素有配伍禁忌：卡那霉素、阿米卡星、柔红霉素、乳糖酸红霉素、硫酸庆大霉素、氢化考的松琥珀酸钠、多粘菌素B、阿霉素、妥布霉素、万古霉素、头孢孟多、头孢氧哌唑、头孢噻吩钠、氯喹丙嗪、异丙嗪、麻醉性镇痛药
氯化铵	磺胺嘧啶	药效降低，不良反应增加	氯化铵与磺胺嘧啶、呋喃妥因配伍禁忌
阿扎司琼	呋喃苯胺酸	药效降低，不良反应增加	阿扎司琼与碱性注射液(如呋喃苯胺酸、甲氯蝶呤、氟尿嘧啶，吡咯他尼等注射液)或鬼臼乙叉甙注射液配伍会发生浑浊或结晶析出，故需将阿扎司琼先用氯化钠注射液稀释后，方可与上述碱性药物配伍使用
肌苷氯化钠注射液	硫喷妥钠	药效降低，不良反应增加	肌苷氯化钠注射液禁与下列注射液配伍：乳清酸、氯霉素、双嘧达莫、盐酸山梗菜碱、硫酸阿托品、氢溴酸东莨菪碱、盐酸氯丙嗪、盐酸异丙嗪、马来酸麦角新碱、盐酸普鲁卡因、硫喷妥钠、苯妥英钠、氯氮卓、盐酸去甲肾上腺素、盐酸丁卡因、利血平、硝普钠、降压嗪、呋噻米、利尿酸钠、促皮质素、维生素B12、盐酸苯海拉明、马来酸氯苯那敏、细胞色素C、盐酸万古霉素、盐酸四环素、二盐酸奎宁、盐酸阿糖胞苷、硫酸长春新碱以及所有菌苗和疫苗
肌苷氯化钠注射液	盐酸异丙嗪	药效降低，不良反应增加	肌苷氯化钠注射液禁与下列注射液配伍：乳清酸、氯霉素、双嘧达莫、盐酸山梗菜碱、硫酸阿托品、氢溴酸东莨菪碱、盐酸氯丙嗪、盐酸异丙嗪、马来酸麦角新碱、盐酸普鲁卡因、硫喷妥钠、苯妥英钠、氯氮卓、盐酸去甲肾上腺素、盐酸丁卡因、利血平、硝普钠、降压嗪、呋噻米、利尿酸钠、促皮质素、维生素B12、盐酸苯海拉明、马来酸氯苯那敏、细胞色素C、盐酸万古霉素、盐酸四环素、二盐酸奎宁、盐酸阿糖胞苷、硫酸长春新碱以及所有菌苗和疫苗
羧苄西林	氯霉素	药效降低，不良反应增加	羧苄西林与琥珀氯霉素、琥乙红霉素、盐酸土霉素、盐酸四环素、卡那霉素、链霉素、庆大霉素、妥布霉素、两性霉素B、维生素B族、维生素C、苯妥英钠、拟交感类药物、异丙嗪等有配伍禁忌
氟哌噻吨美利曲辛胶囊	左旋多巴	药效降低，不良反应增加	氟哌噻吨美利曲辛胶囊会降低左旋多巴的作用，而增加其心脏不良反应的风险
舒巴坦	氨基糖苷类抗生素	药效降低，不良反应增加	由于头孢哌酮／舒巴坦与氨基糖苷类抗生素之间有物理性配伍禁忌，直接混合抗菌活性下降，故不能在同一容器中使用
头孢哌酮	抑肽酶	药效降低，不良反应增加	头孢哌酮与安太乐、普鲁卡因胺、氨茶碱、丙氯拉嗪、细胞色素C、镇痛新、抑肽酶混合后6小时发生外观变化
贝那普利	螺内酯	药效降低，不良反应增加	与潴钾利尿药如螺内酯、氨苯喋啶、阿米洛利合用可引起血钾过高4.与非甾体类抗炎止痛药合用可通过抑制前列腺素合成及水钠潴留，使贝那普利降压作用减弱
肌苷氯化钠注射液	马来酸麦角新碱	药效降低，不良反应增加	肌苷氯化钠注射液禁与下列注射液配伍：乳清酸、氯霉素、双嘧达莫、盐酸山梗菜碱、硫酸阿托品、氢溴酸东莨菪碱、盐酸氯丙嗪、盐酸异丙嗪、马来酸麦角新碱、盐酸普鲁卡因、硫喷妥钠、苯妥英钠、氯氮卓、盐酸去甲肾上腺素、盐酸丁卡因、利血平、硝普钠、降压嗪、呋噻米、利尿酸钠、促皮质素、维生素B12、盐酸苯海拉明、马来酸氯苯那敏、细胞色素C、盐酸万古霉素、盐酸四环素、二盐酸奎宁、盐酸阿糖胞苷、硫酸长春新碱以及所有菌苗和疫苗
西索米星	头孢噻吩	药效降低，不良反应增加	西索米星不宜与两性霉素B、头孢噻吩钠、呋喃妥因钠、磺胺嘧啶钠和四环素等（以上均为注射液）联合应用，因可发生配伍禁忌
头孢米诺	酒精	药效降低，不良反应增加	本口与氨茶碱、磷酸吡哆醛配伍会降低效价或着色，故不得配伍；与呋喃硫胺、硫辛酸，氢化可的松琥珀酸钠及腺苷钴胺配伍后时间稍长会变色，故配伍后应尽快使用；与利尿剂呋(呋喃苯胺酸等)等合用有可能增加肾毒性，应谨慎使用，动物实验证实，头孢米诺影响酒精代谢，使血中乙醛浓度上升，显示双硫仑样作用，故用药期间或用药后应禁酒
肝素	镇痛药	药效降低，不良反应增加	下列药物与肝素有配伍禁忌：卡那霉素、阿米卡星、柔红霉素、乳糖酸红霉素、硫酸庆大霉素、氢化考的松琥珀酸钠、多粘菌素B、阿霉素、妥布霉素、万古霉素、头孢孟多、头孢氧哌唑、头孢噻吩钠、氯喹、氯丙嗪、异丙嗪、麻醉性镇痛药
肌苷氯化钠注射液	细胞色素C	药效降低，不良反应增加	肌苷氯化钠注射液禁与下列注射液配伍：乳清酸、氯霉素、双嘧达莫、盐酸山梗菜碱、硫酸阿托品、氢溴酸东莨菪碱、盐酸氯丙嗪、盐酸异丙嗪、马来酸麦角新碱、盐酸普鲁卡因、硫喷妥钠、苯妥英钠、氯氮卓、盐酸去甲肾上腺素、盐酸丁卡因、利血平、硝普钠、降压嗪、呋噻米、利尿酸钠、促皮质素、维生素B12、盐酸苯海拉明、马来酸氯苯那敏、细胞色素C、盐酸万古霉素、盐酸四环素、二盐酸奎宁、盐酸阿糖胞苷、硫酸长春新碱以及所有菌苗和疫苗
头孢哌酮	复方乳酸钠注射液	药效降低，不良反应增加	头孢哌酮与复方乳酸钠注射液或盐酸利多卡因注射液混合后出现配伍禁忌
羧苄西林	异丙嗪	药效降低，不良反应增加	羧苄西林与琥珀氯霉素、琥乙红霉素、盐酸土霉素、盐酸四环素、卡那霉素、链霉素、庆大霉素、妥布霉素、两性霉素B、维生素B族、维生素C、苯妥英钠、拟交感类药物、异丙嗪等有配伍禁忌
西索米星	呋喃妥因	药效降低，不良反应增加	西索米星不宜与两性霉素B、头孢噻吩钠、呋喃妥因钠、磺胺嘧啶钠和四环素等(以上均为注射液)联合应用，因可发生配伍禁忌
氧	维生素C	药效降低，不良反应增加	氧与氨基糖苷类、去甲肾上腺素、间羟胺、苯巴比妥、维生素B族、维生素C等药物存在配伍禁忌，不宜同瓶滴注
维生素D3	苯妥英钠	药效降低，不良反应增加	巴比妥、苯妥英钠、抗惊厥药、扑米酮等可降低维生素D3的效应，因此长期服用抗惊厥药时应补给维生素D3，以防止骨软化症
利多卡因	巴比妥类	药效降低，不良反应增加	巴比妥类药物可促进利多卡因代谢，两药合用可引起心动过缓，窦性停搏
维生素K	维生素B12	药效降低，不良反应增加	维生素K与苯妥英钠混合2小时后可出现颗粒沉淀，与维生素C、维生素B12、右旋糖酐混合易出现混浊
利福霉素	抗肿瘤药	药效降低，不良反应增加	利福霉素可诱导肝微粒体酶，增加抗肿瘤药达卡巴嗪(dacarbazine)﹑环磷酰胺的代谢，形成烷化代谢物，促使白细胞减低，因此需调整剂量
苯妥英	对乙酰氨基酚	药效降低，不良反应增加	期应用对乙酰氨基酚患者应用苯妥英可增加肝脏中毒的危险，并且疗效降低
利福霉素	环磷酰胺	药效降低，不良反应增加	利福霉素可诱导肝微粒体酶，增加抗肿瘤药达卡巴嗪(dacarbazine)、环磷酰胺的代谢，形成烷化代谢物，促使白细胞减低，因此需调整剂量
丁胺卡那霉素	四环素	药效降低，不良反应增加	丁胺卡那霉素不宜与两性霉素B、头孢噻吩、磺胺嘧啶和四环素等注射剂联合应用，因可发生配伍禁忌
苯唑西林	氨基糖苷类	药效降低，不良反应增加	苯唑西林与氨基糖苷类、去甲肾上腺素、间羟胺、苯巴比妥、维生素B族、维生素C等药物存在配伍禁忌，不宜同瓶滴注
利多卡因Ⅰ	巴比妥类	药效降低，不良反应增加	与西咪替丁以及β受体阻断剂如，普萘洛尔、美托洛尔、纳多洛尔合用，利多卡因经肝脏代谢受抑制，利多卡因血浓度增加，可发生心脏和神经系统不良反应，应调整利多卡因剂量，并应心电图监护及监测利多卡因血药浓度；(2)巴比妥类药物可促进利多卡因代谢，两药合用可引起心动过缓，窦性停搏；(3)与普鲁卡因胺合用，可产生一过性谵妄及幻觉，但不影响利多卡因Ⅰ血药浓度；(4)异丙基肾上腺素因增加肝血流量，可使利多卡因Ⅰ的总清除率升高；去甲肾上腺素因减少肝血流量，可使利多卡因Ⅰ总清除率下降；(5)与下列药品有配伍禁忌：苯巴比妥，硫喷妥钠，硝普钠，甘露醇，两性霉素B，氨苄西林，磺胺嘧啶
头孢哌酮	苯海拉明	药效降低，不良反应增加	头孢哌酮与下列药物注射剂有配伍禁忌：阿米卡星、庆大霉素、卡那霉素B、多西环素、甲氯芬酯、阿马林(缓脉灵)、苯海拉明、门冬酸钾镁、盐酸羟嗪(安太乐)、普鲁卡因胺、氨茶碱、丙氯拉嗪、细胞色素C、喷他佐辛(镇痛新)、抑肽酶等
雷米普利	乙酰水杨酸	药效降低，不良反应增加	非甾体抗炎药物、止痛剂(如消炎痛、乙酰水杨酸)：可能减弱雷米普利的降压效果，还可能增加肾功能损害和血清钾浓度升高的危险
肝素	氯丙嗪	药效降低，不良反应增加	下列药物与肝素有配伍禁忌：卡那霉素、阿米卡星、柔红霉素、乳糖酸红霉素、硫酸庆大霉素、氢化考的松琥珀酸钠、多粘菌素B、阿霉素、妥布霉素、万古霉素、头孢孟多、头孢氧哌唑、头孢噻吩钠、氯喹、氯丙嗪、异丙嗪、麻醉性镇痛药
酮洛芬	利尿剂	药效降低，不良反应增加	病人服用利尿剂同时服用酮洛芬，其风险大大增加，原因之二是酮洛芬抑制的前列腺素合成导致降低了肾脏血流灌注速度
小诺霉素	呋喃妥因	药效降低，不良反应增加	诺霉素不宜与两性霉素B、头孢噻吩钠、呋喃妥因钠、磺胺嘧啶钠和盐酸四环素等（以上均为注射液）联合应用，因可发生配伍禁忌
氯霉素	雌激素	药效降低，不良反应增加	长期使用含雌激素的避孕药，如同时使用氯霉素，可使避孕的可靠性降低.以及经期外出血增加
西索米星氯化钠	两性霉素B	药效降低，不良反应增加	西索米星氯化钠不宜与两性霉素B、头孢噻吩钠、呋喃妥因钠，磺胺嘧啶钠和四环素（以上均为注射液）联合应用，因可发生配伍禁忌
头孢哌酮	卡那霉素	药效降低，不良反应增加	头孢哌酮与下列药物注射剂有配伍禁忌：阿米卡星、庆大霉素、卡那霉素B、多西环素、甲氯芬酯、阿马林(缓脉灵)、苯海拉明、门冬酸钾镁、盐酸羟嗪(安太乐)、普鲁卡因胺、氨茶碱、丙氯拉嗪、细胞色素C、喷他佐辛(镇痛新)、抑肽酶等
左旋多巴	罂粟碱	药效降低，不良反应增加	有报道苯妥英和罂粟碱可逆转左旋多巴对帕金森氏病的疗效
奥硝唑	阿洛西林	药效降低，不良反应增加	奥硝唑与呋布西林钠、萘夫西林钠、奥美拉唑、沃必唑、注射用炎琥宁、阿洛西林钠存在配伍禁忌
西索米星	头孢噻吩	药效降低，不良反应增加	西索米星不宜与两性霉素B、头孢噻吩钠、呋喃妥因钠、磺胺嘧啶钠和四环素等(以上均为注射液)联合应用，因可发生配伍禁忌
维生素K1	维生素C	药效降低，不良反应增加	维生素K1与苯妥英钠混合2小时后可出现颗粒沉淀，与维生素C、维生素B12、右旋糖酐混合易出现混浊
氯化钠	氟尿嘧啶	药效降低，不良反应增加	氯化钠与碱性注射液（如呋喃苯胺酸、甲氨蝶呤、氟尿嘧啶、吡咯他尼注射液）或鬼臼乙叉甙注射液配伍会发生浑浊或结晶析出，故不宜与上述药物同时应用
肌苷氯化钠注射液	苯妥英钠	药效降低，不良反应增加	肌苷氯化钠注射液禁与下列注射液配伍：乳清酸、氯霉素、双嘧达莫、盐酸山梗菜碱、硫酸阿托品、氢溴酸东莨菪碱、盐酸氯丙嗪、盐酸异丙嗪、马来酸麦角新碱、盐酸普鲁卡因、硫喷妥钠、苯妥英钠、氯氮卓、盐酸去甲肾上腺素、盐酸丁卡因、利血平、硝普钠、降压嗪、呋噻米、利尿酸钠、促皮质素、维生素B12、盐酸苯海拉明、马来酸氯苯那敏、细胞色素C、盐酸万古霉素、盐酸四环素、二盐酸奎宁、盐酸阿糖胞苷、硫酸长春新碱以及所有菌苗和疫苗
复方氨酚愈敏	三环类抗抑郁药	药效降低，不良反应增加	与三环类抗抑郁药如马普替林同用时，降低复方氨酚愈敏的加压作用
利福平	达卡巴嗪	药效降低，不良反应增加	利福平可诱导肝微粒体酶，增加抗肿瘤药达卡巴嗪(dacarbazine)、环磷酰胺的代谢，形成烷化代谢物，促使白细胞减低，因此需调整剂量
肌苷氯化钠注射液	利血平	药效降低，不良反应增加	肌苷氯化钠注射液禁与下列注射液配伍：乳清酸、氯霉素、双嘧达莫、盐酸山梗菜碱、硫酸阿托品、氢溴酸东莨菪碱、盐酸氯丙嗪、盐酸异丙嗪、马来酸麦角新碱、盐酸普鲁卡因、硫喷妥钠、苯妥英钠、氯氮卓、盐酸去甲肾上腺素、盐酸丁卡因、利血平、硝普钠、降压嗪、呋噻米、利尿酸钠、促皮质素、维生素B12、盐酸苯海拉明、马来酸氯苯那敏、细胞色素C、盐酸万古霉素、盐酸四环素、二盐酸奎宁、盐酸阿糖胞苷、硫酸长春新碱以及所有菌苗和疫苗
氨苄西林	维生素C	药效降低，不良反应增加	氨苄西林与氨基糖苷类、去甲肾上腺素、间羟胺、苯巴比妥、维生素B族、维生素C等药物存在配伍禁忌，不宜同瓶滴注
利多卡因Ⅰ	去甲肾上腺素	药效降低，不良反应增加	与西咪替丁以及β受体阻断剂如，普萘洛尔、美托洛尔、纳多洛尔合用，利多卡因经肝脏代谢受抑制，利多卡因血浓度增加，可发生心脏和神经系统不良反应，应调整利多卡因剂量，并应心电图监护及监测利多卡因血药浓度；(2)巴比妥类药物可促进利多卡因代谢，两药合用可引起心动过缓，窦性停搏；(3)与普鲁卡因胺合用，可产生一过性谵妄及幻觉，但不影响利多卡因Ⅰ血药浓度；(4)异丙基肾上腺素因增加肝血流量，可使利多卡因Ⅰ的总清除率升高；去甲肾上腺素因减少肝血流量，可使利多卡因Ⅰ总清除率下降；(5)与下列药品有配伍禁忌：苯巴比妥，硫喷妥钠，硝普钠，甘露醇，两性霉素B，氨苄西林，磺胺嘧啶
氯化钠	磺胺嘧啶	药效降低，不良反应增加	氯化钠不宜与两性霉素B、头孢噻吩钠、呋喃妥因钠，磺胺嘧啶钠和四环素（以上均为注射液）联合应用，因可发生配伍禁忌
利多卡因Ⅰ	硝普钠	药效降低，不良反应增加	与西咪替丁以及β受体阻断剂如，普萘洛尔、美托洛尔、纳多洛尔合用，利多卡因经肝脏代谢受抑制，利多卡因血浓度增加，可发生心脏和神经系统不良反应，应调整利多卡因剂量，并应心电图监护及监测利多卡因血药浓度；(2)巴比妥类药物可促进利多卡因代谢，两药合用可引起心动过缓，窦性停搏；(3)与普鲁卡因胺合用，可产生一过性谵妄及幻觉，但不影响利多卡因Ⅰ血药浓度；(4)异丙基肾上腺素因增加肝血流量，可使利多卡因Ⅰ的总清除率升高；去甲肾上腺素因减少肝血流量，可使利多卡因Ⅰ总清除率下降；(5)与下列药品有配伍禁忌：苯巴比妥，硫喷妥钠，硝普钠，甘露醇，两性霉素B，氨苄西林，磺胺嘧啶
肌苷氯化钠注射液	氯霉素	药效降低，不良反应增加	肌苷氯化钠注射液禁与下列注射液配伍：乳清酸、氯霉素、双嘧达莫、盐酸山梗菜碱、硫酸阿托品、氢溴酸东莨菪碱、盐酸氯丙嗪、盐酸异丙嗪、马来酸麦角新碱、盐酸普鲁卡因、硫喷妥钠、苯妥英钠、氯氮卓、盐酸去甲肾上腺素、盐酸丁卡因、利血平、硝普钠、降压嗪、呋噻米、利尿酸钠、促皮质素、维生素B12、盐酸苯海拉明、马来酸氯苯那敏、细胞色素C、盐酸万古霉素、盐酸四环素、二盐酸奎宁、盐酸阿糖胞苷、硫酸长春新碱以及所有菌苗和疫苗
赖诺普利	吲哚美辛	药效降低，不良反应增加	非甾体类抗炎止痛药尤其吲哚美辛可抑制肾前列腺素合成，并引起水、钠潴留，减弱赖诺普利的降压作用
肝素	柔红霉素	药效降低，不良反应增加	下列药物与肝素有配伍禁忌：卡那霉素、阿米卡星、柔红霉素、乳糖酸红霉素、硫酸庆大霉素、氢化考的松琥珀酸钠、多粘菌素B、阿霉素、妥布霉素、万古霉素、头孢孟多、头孢氧哌唑、头孢噻吩钠、氯喹、氯丙嗪、异丙嗪、麻醉性镇痛药
氨苄西林	氨基糖苷类	药效降低，不良反应增加	氨苄西林与氨基糖苷类、去甲肾上腺素、间羟胺、苯巴比妥、维生素B族、维生素C等药物存在配伍禁忌，不宜同瓶滴注
博来霉素	地高辛	药效降低，不良反应增加	与地高辛合用时，博来霉素可降低地高辛的治疗作用，继发心脏代偿失调
奥硝唑	炎琥宁	药效降低，不良反应增加	文献报道，奥硝唑与呋布西林钠、萘夫西林钠、奥美拉唑、沃必唑、注射用炎琥宁、阿洛西林钠存在配伍禁忌，左奥硝唑在使用时也应注意
氧	苯巴比妥	药效降低，不良反应增加	氧与氨基糖苷类、去甲肾上腺素、间羟胺、苯巴比妥、维生素B族、维生素C等药物存在配伍禁忌，不宜同瓶滴注
苯妥英钠	对乙酰氨基酚	药效降低，不良反应增加	期应用对乙酰氨基酚患者应用苯妥英钠可增加肝脏中毒的危险，并且疗效降低
利福平	抗肿瘤药	药效降低，不良反应增加	利福平可诱导肝微粒体酶，增加抗肿瘤药达卡巴嗪(dacarbazine)﹑环磷酰胺的代谢，形成烷化代谢物，促使白细胞减低，因此需调整剂量
复方地塞米松	利福平	药效降低，不良反应增加	利福平可增强复方地塞米松的代谢，增加肝脏毒性，合用时可降低复方地塞米松的血药浓度，导致治疗失败
利福平	达卡巴嗪	药效降低，不良反应增加	利福平可诱导肝微粒体酶，增加抗肿瘤药达卡巴嗪(dacarbazine)、环磷酰胺的代谢、烷化代谢物的形成，促使白细胞减低，因此需调整剂量
咪康唑	利福平	药效降低，不良反应增加	利福平可增强咪康唑的代谢，增加肝脏毒性，合用时可降低咪康唑的血药浓度，导致治疗失败
奥硝唑	奥美拉唑	药效降低，不良反应增加	文献报道，奥硝唑与呋布西林钠、萘夫西林钠、奥美拉唑、沃必唑、注射用炎琥宁、阿洛西林钠存在配伍禁忌，左奥硝唑在使用时也应注意
西索米星	四环素	药效降低，不良反应增加	西索米星不宜与两性霉素B、头孢噻吩钠、呋喃妥因钠、磺胺嘧啶钠和四环素等（以上均为注射液）联合应用，因可发生配伍禁忌
奥硝唑	巴比妥类	药效降低，不良反应增加	巴比妥类药物、雷尼替丁、西米替丁可加快奥硝唑的消除，降低其疗效并可凝血，当使用奥硝唑时应避免合用
卡那霉素	两性霉素B	药效降低，不良反应增加	卡那霉素不宜与两性霉素B、头孢噻吩、磺胺嘧啶和四环素等注射剂联合应用，因可发生配伍禁忌
雷米普利	乙酰水杨酸	药效降低，不良反应增加	－非甾体抗炎药物、止痛剂（如消炎痛、乙酰水杨酸）：可能减弱雷米普利的降压效果；还可能增加肾功能损害和血清钾浓度升高的危险
左奥硝唑	呋布西林	药效降低，不良反应增加	文献报道，奥硝唑与呋布西林钠、萘夫西林钠、奥美拉唑、沃必唑、注射用炎琥宁、阿洛西林钠存在配伍禁忌，左奥硝唑在使用时也应注意
利多卡因	巴比妥类	药效降低，不良反应增加	巴比妥类药物可促进利多卡因代谢，两药合用可引起心动过缓，窦性停搏；
肝素	阿米卡星	药效降低，不良反应增加	下列药物与肝素有配伍禁忌：卡那霉素、阿米卡星、柔红霉素、乳糖酸红霉素、硫酸庆大霉素、氢化考的松琥珀酸钠、多粘菌素B、阿霉素、妥布霉素、万古霉素、头孢孟多、头孢氧哌唑、头孢噻吩钠、氯喹、氯丙嗪、异丙嗪、麻醉性镇痛药
奥硝唑	阿洛西林	药效降低，不良反应增加	文献报道，奥硝唑与呋布西林钠、萘夫西林钠、奥美拉唑、沃必唑、注射用炎琥宁、阿洛西林钠存在配伍禁忌，左奥硝唑在使用时也应注意
西索米星	头孢噻吩	药效降低，不良反应增加	西索米星不宜与两性霉素B、头孢噻吩钠、呋喃妥因钠，磺胺嘧啶钠和四环素（以上均为注射液）联合应用，因可发生配伍禁忌
利多卡因Ⅰ	普鲁卡因胺	药效降低，不良反应增加	与西咪替丁以及β受体阻断剂如，普萘洛尔、美托洛尔、纳多洛尔合用，利多卡因经肝脏代谢受抑制，利多卡因血浓度增加，可发生心脏和神经系统不良反应，应调整利多卡因剂量，并应心电图监护及监测利多卡因血药浓度；(2)巴比妥类药物可促进利多卡因代谢，两药合用可引起心动过缓，窦性停搏；(3)与普鲁卡因胺合用，可产生一过性谵妄及幻觉，但不影响利多卡因Ⅰ血药浓度；(4)异丙基肾上腺素因增加肝血流量，可使利多卡因Ⅰ的总清除率升高；去甲肾上腺素因减少肝血流量，可使利多卡因Ⅰ总清除率下降；(5)与下列药品有配伍禁忌：苯巴比妥，硫喷妥钠，硝普钠，甘露醇，两性霉素B，氨苄西林，磺胺嘧啶
可待因	茶碱	药效降低，不良反应增加	可待因与茶碱合用，不良反应增多，使后者的疗效降低
小诺霉素	头孢噻吩	药效降低，不良反应增加	小诺霉素不宜与两性霉素B、头孢噻吩钠、呋喃妥因钠、磺胺嘧啶钠和盐酸四环素等（以上均为注射液）联合应用，因可发生配伍禁忌
氯霉素	雌激素	药效降低，不良反应增加	长期口服含雌激素的避孕药，如同时服用氯霉素，可使避孕的可靠性降低，以及经期外出血增加
头孢哌酮	普鲁卡因胺	药效降低，不良反应增加	头孢哌酮与安太乐、普鲁卡因胺、氨茶碱、丙氯拉嗪、细胞色素C、镇痛新、抑肽酶混合后1/2小时发生外观变化
注射用盐酸丁卡因	碘	药效降低，不良反应增加	注射部位不能遇碘，以防引起注射用盐酸丁卡因沉淀
吡罗昔康	阿司匹林	药效降低，不良反应增加	与阿司匹林同用时，吡罗昔康的血药浓度可下降到一般浓度的80%，同时肠胃道溃疡形成和出血倾向的危险性增加
羧苄西林	维生素C	药效降低，不良反应增加	羧苄西林与琥珀氯霉素、琥乙红霉素、盐酸土霉素、盐酸四环素、卡那霉素、链霉素、庆大霉素、妥布霉素、两性霉素B、维生素B族、维生素C、苯妥英钠、拟交感类药物、异丙嗪等有配伍禁忌
青霉素	氨基糖苷类	药效降低，不良反应增加	青霉素与氨基糖苷类、去甲肾上腺素、间羟胺、苯巴比妥、维生素B族、维生素C等药物存在配伍禁忌，不宜同瓶滴注
萘夫西林	苯巴比妥	药效降低，不良反应增加	萘夫西林与氨基糖苷类、去甲肾上腺素、间羟胺、苯巴比妥、维生素B族、维生素C等药物存在配伍禁忌，不宜同瓶滴注
阿米卡星	头孢噻吩	药效降低，不良反应增加	阿米卡星不宜与两性霉素B、头孢噻吩、磺胺嘧啶和四环素等注射剂联合应用，因可发生配伍禁忌
胰岛素	水杨酸	药效降低，不良反应增加	抗凝血药、水杨酸盐、磺胺类药及抗肿瘤药甲氨喋呤等可与胰岛素竞争和血浆蛋白结合，从而使血液中游离胰岛素水平增高
咪康唑	西沙必利	药效降低，不良反应增加	咪康唑与西沙必利合用属禁忌，因合用时抑制细胞色素P-450代谢通道，可导致心律紊乱
利福定	达卡巴嗪	药效降低，不良反应增加	利福定可诱导肝微粒体酶，增加抗肿瘤药达卡巴嗪(dacarbazine)、环磷酰胺的代谢，形成烷化代谢物，促使白细胞减低，因此需调整剂量
奥硝唑	西米替丁	药效降低，不良反应增加	巴比妥类药物、雷尼替丁、西米替丁可加快奥硝唑的消除，降低其疗效并可凝血，当使用奥硝唑时应避免合用
头孢哌酮	氨基糖苷类抗生素	药效降低，不良反应增加	但头孢哌酮与氨基糖苷类抗生素之间存在着物理性配伍禁忌，因此两种药液不能直接混合
西索米星氯化钠	四环素	药效降低，不良反应增加	西索米星氯化钠不宜与两性霉素B、头孢噻吩钠、呋喃妥因钠，磺胺嘧啶钠和四环素（以上均为注射液）联合应用，因可发生配伍禁忌
氯唑西林	间羟胺	药效降低，不良反应增加	氯唑西林与氨基糖苷类、去甲肾上腺素、间羟胺、苯巴比妥、维生素B族、维生素C等药物存在配伍禁忌，不宜同瓶滴注
